4
(name1)	(name2)	(file)	(line)
AVIBuildFilter	AVIBuildFilterW		1
AVIFileClose	AVIFileRelease		1
AVIFileCreateStream	AVIFileCreateStreamW		1
AVIFileInfo	AVIFileInfoW		1
AVIFileOpen	AVIFileOpenW		1
AVISave	AVISaveW		1
AVISaveV	AVISaveVW		1
AVIStreamClose	AVIStreamRelease		1
AVIStreamExit	AVIFileExit		1
AVIStreamFindKeyFrame	AVIStreamFindSample		1
AVIStreamInfo	AVIStreamInfoW		1
AVIStreamInit	AVIFileInit		1
AVIStreamOpenFromFile	AVIStreamOpenFromFileW		1
AbnormalTermination	_abnormal_termination		1
AbortSystemShutdown	AbortSystemShutdownW		1
AccessCheckAndAuditAlarm	AccessCheckAndAuditAlarmW		1
AccessCheckByTypeAndAuditAlarm	AccessCheckByTypeAndAuditAlarmW		1
AccessCheckByTypeResultListAndAuditAlarm	AccessCheckByTypeResultListAndAuditAlarmW		1
AccessCheckByTypeResultListAndAuditAlarmByHandle	AccessCheckByTypeResultListAndAuditAlarmByHandleW		1
AcquireCredentialsHandle	AcquireCredentialsHandleW		1
AddAtom	AddAtomW		1
AddConsoleAlias	AddConsoleAliasW		1
AddCredentials	AddCredentialsW		1
AddERExcludedApplication	AddERExcludedApplicationW		1
AddFontResource	AddFontResourceW		1
AddFontResourceEx	AddFontResourceExW		1
AddForm	AddFormW		1
AddJob	AddJobW		1
AddMonitor	AddMonitorW		1
AddPort	AddPortW		1
AddPrintProcessor	AddPrintProcessorW		1
AddPrintProvidor	AddPrintProvidorW		1
AddPrinter	AddPrinterW		1
AddPrinterConnection	AddPrinterConnectionW		1
AddPrinterDriver	AddPrinterDriverW		1
AddPrinterDriverEx	AddPrinterDriverExW		1
AddSecurityPackage	AddSecurityPackageW		1
AdvancedDocumentProperties	AdvancedDocumentPropertiesW		1
AnsiLower	CharLowerA		1
AnsiLowerBuff	CharLowerBuffA		1
AnsiNext	CharNextA		1
AnsiPrev	CharPrevA		1
AnsiToOem	CharToOemA		1
AnsiToOemBuff	CharToOemBuffA		1
AnsiUpper	CharUpperA		1
AnsiUpperBuff	CharUpperBuffA		1
AppendMenu	AppendMenuW		1
AssocQueryKey	AssocQueryKeyW		1
AssocQueryString	AssocQueryStringW		1
AssocQueryStringByKey	AssocQueryStringByKeyW		1
AuditLookupCategoryName	AuditLookupCategoryNameW		1
AuditLookupSubCategoryName	AuditLookupSubCategoryNameW		1
AuditQueryGlobalSacl	AuditQueryGlobalSaclW		1
AuditSetGlobalSacl	AuditSetGlobalSaclW		1
BackupEventLog	BackupEventLogW		1
BeginUpdateResource	BeginUpdateResourceW		1
BitScanForward	_BitScanForward		1
BitScanReverse	_BitScanReverse		1
BitTest	_bittest		1
BitTestAndComplement	_bittestandcomplement		1
BitTestAndReset	_bittestandreset		1
BitTestAndSet	_bittestandset		1
BroadcastSystemMessage	BroadcastSystemMessageW		1
BroadcastSystemMessageEx	BroadcastSystemMessageExW		1
BuildCommDCB	BuildCommDCBW		1
BuildCommDCBAndTimeouts	BuildCommDCBAndTimeoutsW		1
CATID_NULL	GUID_NULL		1
CGID_BandSite	IID_IBandSite		1
CGID_DeskBand	IID_IDeskBand		1
CLSID_NULL	GUID_NULL		1
CM_Add_ID	CM_Add_IDW		1
CM_Add_ID_Ex	CM_Add_ID_ExW		1
CM_Connect_Machine	CM_Connect_MachineW		1
CM_Create_DevInst	CM_Create_DevNodeW		1
CM_Create_DevInstA	CM_Create_DevNodeA		1
CM_Create_DevInstW	CM_Create_DevNodeW		1
CM_Create_DevInst_Ex	CM_Create_DevNode_ExW		1
CM_Create_DevInst_ExA	CM_Create_DevNode_ExA		1
CM_Create_DevInst_ExW	CM_Create_DevNode_ExW		1
CM_Create_DevNode	CM_Create_DevNodeW		1
CM_Create_DevNode_Ex	CM_Create_DevNode_ExW		1
CM_Delete_DevInst_Key	CM_Delete_DevNode_Key		1
CM_Delete_DevInst_Key_Ex	CM_Delete_DevNode_Key_Ex		1
CM_Disable_DevInst	CM_Disable_DevNode		1
CM_Disable_DevInst_Ex	CM_Disable_DevNode_Ex		1
CM_Enable_DevInst	CM_Enable_DevNode		1
CM_Enable_DevInst_Ex	CM_Enable_DevNode_Ex		1
CM_Enumerate_Enumerators	CM_Enumerate_EnumeratorsW		1
CM_Enumerate_Enumerators_Ex	CM_Enumerate_Enumerators_ExW		1
CM_Get_Class_Key_Name	CM_Get_Class_Key_NameW		1
CM_Get_Class_Key_Name_Ex	CM_Get_Class_Key_Name_ExW		1
CM_Get_Class_Name	CM_Get_Class_NameW		1
CM_Get_Class_Name_Ex	CM_Get_Class_Name_ExW		1
CM_Get_Class_Registry_Property	CM_Get_Class_Registry_PropertyW		1
CM_Get_DevInst_Custom_Property	CM_Get_DevNode_Custom_PropertyW		1
CM_Get_DevInst_Custom_PropertyA	CM_Get_DevNode_Custom_PropertyA		1
CM_Get_DevInst_Custom_PropertyW	CM_Get_DevNode_Custom_PropertyW		1
CM_Get_DevInst_Custom_Property_Ex	CM_Get_DevNode_Custom_Property_ExW		1
CM_Get_DevInst_Custom_Property_ExA	CM_Get_DevNode_Custom_Property_ExA		1
CM_Get_DevInst_Custom_Property_ExW	CM_Get_DevNode_Custom_Property_ExW		1
CM_Get_DevInst_Registry_Property	CM_Get_DevNode_Registry_PropertyW		1
CM_Get_DevInst_Registry_PropertyA	CM_Get_DevNode_Registry_PropertyA		1
CM_Get_DevInst_Registry_PropertyW	CM_Get_DevNode_Registry_PropertyW		1
CM_Get_DevInst_Registry_Property_Ex	CM_Get_DevNode_Registry_Property_ExW		1
CM_Get_DevInst_Registry_Property_ExA	CM_Get_DevNode_Registry_Property_ExA		1
CM_Get_DevInst_Registry_Property_ExW	CM_Get_DevNode_Registry_Property_ExW		1
CM_Get_DevInst_Status	CM_Get_DevNode_Status		1
CM_Get_DevInst_Status_Ex	CM_Get_DevNode_Status_Ex		1
CM_Get_DevNode_Custom_Property	CM_Get_DevNode_Custom_PropertyW		1
CM_Get_DevNode_Custom_Property_Ex	CM_Get_DevNode_Custom_Property_ExW		1
CM_Get_DevNode_Registry_Property	CM_Get_DevNode_Registry_PropertyW		1
CM_Get_DevNode_Registry_Property_Ex	CM_Get_DevNode_Registry_Property_ExW		1
CM_Get_Device_ID	CM_Get_Device_IDW		1
CM_Get_Device_ID_Ex	CM_Get_Device_ID_ExW		1
CM_Get_Device_ID_List	CM_Get_Device_ID_ListW		1
CM_Get_Device_ID_List_Ex	CM_Get_Device_ID_List_ExW		1
CM_Get_Device_ID_List_Size	CM_Get_Device_ID_List_SizeW		1
CM_Get_Device_ID_List_Size_Ex	CM_Get_Device_ID_List_Size_ExW		1
CM_Get_Device_Interface_Alias	CM_Get_Device_Interface_AliasW		1
CM_Get_Device_Interface_Alias_Ex	CM_Get_Device_Interface_Alias_ExW		1
CM_Get_Device_Interface_List	CM_Get_Device_Interface_ListW		1
CM_Get_Device_Interface_List_Ex	CM_Get_Device_Interface_List_ExW		1
CM_Get_Device_Interface_List_Size	CM_Get_Device_Interface_List_SizeW		1
CM_Get_Device_Interface_List_Size_Ex	CM_Get_Device_Interface_List_Size_ExW		1
CM_Get_HW_Prof_Flags	CM_Get_HW_Prof_FlagsW		1
CM_Get_HW_Prof_Flags_Ex	CM_Get_HW_Prof_Flags_ExW		1
CM_Get_Hardware_Profile_Info	CM_Get_Hardware_Profile_InfoW		1
CM_Get_Hardware_Profile_Info_Ex	CM_Get_Hardware_Profile_Info_ExW		1
CM_Get_Resource_Conflict_Details	CM_Get_Resource_Conflict_DetailsW		1
CM_Locate_DevInst	CM_Locate_DevNodeW		1
CM_Locate_DevInstA	CM_Locate_DevNodeA		1
CM_Locate_DevInstW	CM_Locate_DevNodeW		1
CM_Locate_DevInst_Ex	CM_Locate_DevNode_ExW		1
CM_Locate_DevInst_ExA	CM_Locate_DevNode_ExA		1
CM_Locate_DevInst_ExW	CM_Locate_DevNode_ExW		1
CM_Locate_DevNode	CM_Locate_DevNodeW		1
CM_Locate_DevNode_Ex	CM_Locate_DevNode_ExW		1
CM_Move_DevInst	CM_Move_DevNode		1
CM_Move_DevInst_Ex	CM_Move_DevNode_Ex		1
CM_Open_Class_Key	CM_Open_Class_KeyW		1
CM_Open_Class_Key_Ex	CM_Open_Class_Key_ExW		1
CM_Open_DevInst_Key	CM_Open_DevNode_Key		1
CM_Open_DevInst_Key_Ex	CM_Open_DevNode_Key_Ex		1
CM_Query_And_Remove_SubTree	CM_Query_And_Remove_SubTreeW		1
CM_Query_And_Remove_SubTree_Ex	CM_Query_And_Remove_SubTree_ExW		1
CM_Reenumerate_DevInst	CM_Reenumerate_DevNode		1
CM_Reenumerate_DevInst_Ex	CM_Reenumerate_DevNode_Ex		1
CM_Register_Device_Interface	CM_Register_Device_InterfaceW		1
CM_Register_Device_Interface_Ex	CM_Register_Device_Interface_ExW		1
CM_Request_Device_Eject	CM_Request_Device_EjectW		1
CM_Request_Device_Eject_Ex	CM_Request_Device_Eject_ExW		1
CM_Set_Class_Registry_Property	CM_Set_Class_Registry_PropertyW		1
CM_Set_DevInst_Problem	CM_Set_DevNode_Problem		1
CM_Set_DevInst_Problem_Ex	CM_Set_DevNode_Problem_Ex		1
CM_Set_DevInst_Registry_Property	CM_Set_DevNode_Registry_PropertyW		1
CM_Set_DevInst_Registry_PropertyA	CM_Set_DevNode_Registry_PropertyA		1
CM_Set_DevInst_Registry_PropertyW	CM_Set_DevNode_Registry_PropertyW		1
CM_Set_DevInst_Registry_Property_Ex	CM_Set_DevNode_Registry_Property_ExW		1
CM_Set_DevInst_Registry_Property_ExA	CM_Set_DevNode_Registry_Property_ExA		1
CM_Set_DevInst_Registry_Property_ExW	CM_Set_DevNode_Registry_Property_ExW		1
CM_Set_DevNode_Registry_Property	CM_Set_DevNode_Registry_PropertyW		1
CM_Set_DevNode_Registry_Property_Ex	CM_Set_DevNode_Registry_Property_ExW		1
CM_Set_HW_Prof_Flags	CM_Set_HW_Prof_FlagsW		1
CM_Set_HW_Prof_Flags_Ex	CM_Set_HW_Prof_Flags_ExW		1
CM_Setup_DevInst	CM_Setup_DevNode		1
CM_Setup_DevInst_Ex	CM_Setup_DevNode_Ex		1
CM_Uninstall_DevInst	CM_Uninstall_DevNode		1
CM_Uninstall_DevInst_Ex	CM_Uninstall_DevNode_Ex		1
CM_Unregister_Device_Interface	CM_Unregister_Device_InterfaceW		1
CM_Unregister_Device_Interface_Ex	CM_Unregister_Device_Interface_ExW		1
CM_WaitNoPendingInstallEvents	CMP_WaitNoPendingInstallEvents		1
CallMsgFilter	CallMsgFilterW		1
CallNamedPipe	CallNamedPipeW		1
CallWindowProc	CallWindowProcW		1
CdChangerClassGuid	GUID_DEVINTERFACE_CDCHANGER		1
CdRomClassGuid	GUID_DEVINTERFACE_CDROM		1
CertAddEncodedCertificateToSystemStore	CertAddEncodedCertificateToSystemStoreW		1
CertGetNameString	CertGetNameStringW		1
CertNameToStr	CertNameToStrW		1
CertOpenSystemStore	CertOpenSystemStoreW		1
CertRDNValueToStr	CertRDNValueToStrW		1
CertStrToName	CertStrToNameW		1
ChangeAccountPassword	ChangeAccountPasswordW		1
ChangeDisplaySettings	ChangeDisplaySettingsW		1
ChangeDisplaySettingsEx	ChangeDisplaySettingsExW		1
ChangeMenu	ChangeMenuW		1
ChangeServiceConfig	ChangeServiceConfigW		1
ChangeServiceConfig2	ChangeServiceConfig2W		1
CharLower	CharLowerW		1
CharLowerBuff	CharLowerBuffW		1
CharNext	CharNextW		1
CharPrev	CharPrevW		1
CharToOem	CharToOemW		1
CharToOemBuff	CharToOemBuffW		1
CharUpper	CharUpperW		1
CharUpperBuff	CharUpperBuffW		1
CheckNameLegalDOS8Dot3	CheckNameLegalDOS8Dot3W		1
ChooseColor	ChooseColorW		1
ChooseFont	ChooseFontW		1
ChrCmpI	ChrCmpIW		1
ClearEventLog	ClearEventLogW		1
CommConfigDialog	CommConfigDialogW		1
CommitUrlCacheEntry	CommitUrlCacheEntryW		1
CompareString	CompareStringW		1
ConfigurePort	ConfigurePortW		1
CopyAcceleratorTable	CopyAcceleratorTableW		1
CopyEnhMetaFile	CopyEnhMetaFileW		1
CopyFile	CopyFileW		1
CopyFileEx	CopyFileExW		1
CopyMetaFile	CopyMetaFileW		1
CreateAcceleratorTable	CreateAcceleratorTableW		1
CreateActCtx	CreateActCtxW		1
CreateColorSpace	CreateColorSpaceW		1
CreateDC	CreateDCW		1
CreateDesktop	CreateDesktopW		1
CreateDesktopEx	CreateDesktopExW		1
CreateDialogIndirectParam	CreateDialogIndirectParamW		1
CreateDialogParam	CreateDialogParamW		1
CreateDirectory	CreateDirectoryW		1
CreateDirectoryEx	CreateDirectoryExW		1
CreateEnhMetaFile	CreateEnhMetaFileW		1
CreateEvent	CreateEventW		1
CreateFile	CreateFileW		1
CreateFileMapping	CreateFileMappingW		1
CreateFont	CreateFontW		1
CreateFontIndirect	CreateFontIndirectW		1
CreateFontIndirectEx	CreateFontIndirectExW		1
CreateHardLink	CreateHardLinkW		1
CreateIC	CreateICW		1
CreateJobObject	CreateJobObjectW		1
CreateMDIWindow	CreateMDIWindowW		1
CreateMailslot	CreateMailslotW		1
CreateMetaFile	CreateMetaFileW		1
CreateMutex	CreateMutexW		1
CreateNamedPipe	CreateNamedPipeW		1
CreateProcess	CreateProcessW		1
CreateProcessAsUser	CreateProcessAsUserW		1
CreatePropertySheetPage	CreatePropertySheetPageW		1
CreateScalableFontResource	CreateScalableFontResourceW		1
CreateSemaphore	CreateSemaphoreW		1
CreateService	CreateServiceW		1
CreateStatusWindow	CreateStatusWindowW		1
CreateStdAccessibleProxy	CreateStdAccessibleProxyW		1
CreateUrlCacheEntry	CreateUrlCacheEntryW		1
CreateWaitableTimer	CreateWaitableTimerW		1
CreateWindowEx	CreateWindowExW		1
CreateWindowStation	CreateWindowStationW		1
CredDelete	CredDeleteW		1
CredEnumerate	CredEnumerateW		1
CredFindBestCredential	CredFindBestCredentialW		1
CredGetTargetInfo	CredGetTargetInfoW		1
CredIsMarshaledCredential	CredIsMarshaledCredentialW		1
CredIsProtected	CredIsProtectedW		1
CredMarshalCredential	CredMarshalCredentialW		1
CredPackAuthenticationBuffer	CredPackAuthenticationBufferW		1
CredProtect	CredProtectW		1
CredRead	CredReadW		1
CredReadDomainCredentials	CredReadDomainCredentialsW		1
CredRename	CredRenameW		1
CredUICmdLinePromptForCredentials	CredUICmdLinePromptForCredentialsW		1
CredUIConfirmCredentials	CredUIConfirmCredentialsW		1
CredUIParseUserName	CredUIParseUserNameW		1
CredUIPromptForCredentials	CredUIPromptForCredentialsW		1
CredUIPromptForWindowsCredentials	CredUIPromptForWindowsCredentialsW		1
CredUnPackAuthenticationBuffer	CredUnPackAuthenticationBufferW		1
CredUnmarshalCredential	CredUnmarshalCredentialW		1
CredUnprotect	CredUnprotectW		1
CredWrite	CredWriteW		1
CredWriteDomainCredentials	CredWriteDomainCredentialsW		1
CryptAcquireContext	CryptAcquireContextW		1
CryptBinaryToString	CryptBinaryToStringW		1
CryptEnumProviderTypes	CryptEnumProviderTypesW		1
CryptEnumProviders	CryptEnumProvidersW		1
CryptGetDefaultProvider	CryptGetDefaultProviderW		1
CryptRetrieveObjectByUrl	CryptRetrieveObjectByUrlW		1
CryptSetProvider	CryptSetProviderW		1
CryptSetProviderEx	CryptSetProviderExW		1
CryptSignHash	CryptSignHashW		1
CryptStringToBinary	CryptStringToBinaryW		1
CryptVerifySignature	CryptVerifySignatureW		1
DceErrorInqText	DceErrorInqTextW		1
DdeCreateStringHandle	DdeCreateStringHandleW		1
DdeInitialize	DdeInitializeW		1
DdeQueryString	DdeQueryStringW		1
DecryptFile	DecryptFileW		1
DefDlgProc	DefDlgProcW		1
DefFrameProc	DefFrameProcW		1
DefMDIChildProc	DefMDIChildProcW		1
DefWindowProc	DefWindowProcW		1
DefineDosDevice	DefineDosDeviceW		1
DeleteFile	DeleteFileW		1
DeleteForm	DeleteFormW		1
DeleteMonitor	DeleteMonitorW		1
DeletePort	DeletePortW		1
DeletePrintProcessor	DeletePrintProcessorW		1
DeletePrintProvidor	DeletePrintProvidorW		1
DeletePrinterConnection	DeletePrinterConnectionW		1
DeletePrinterData	DeletePrinterDataW		1
DeletePrinterDataEx	DeletePrinterDataExW		1
DeletePrinterDriver	DeletePrinterDriverW		1
DeletePrinterDriverEx	DeletePrinterDriverExW		1
DeletePrinterKey	DeletePrinterKeyW		1
DeleteProfile	DeleteProfileW		1
DeleteSecurityPackage	DeleteSecurityPackageW		1
DeleteUrlCacheEntry	DeleteUrlCacheEntryW		1
DeleteVolumeMountPoint	DeleteVolumeMountPointW		1
DeviceCapabilities	DeviceCapabilitiesW		1
DialogBoxIndirectParam	DialogBoxIndirectParamW		1
DialogBoxParam	DialogBoxParamW		1
DiskClassGuid	GUID_DEVINTERFACE_DISK		1
DispatchMessage	DispatchMessageW		1
DlgDirList	DlgDirListW		1
DlgDirListComboBox	DlgDirListComboBoxW		1
DlgDirSelectComboBoxEx	DlgDirSelectComboBoxExW		1
DlgDirSelectEx	DlgDirSelectExW		1
DnsHostnameToComputerName	DnsHostnameToComputerNameW		1
DoEnvironmentSubst	DoEnvironmentSubstW		1
DocumentProperties	DocumentPropertiesW		1
DragQueryFile	DragQueryFileW		1
DrawState	DrawStateW		1
DrawStatusText	DrawStatusTextW		1
DrawText	DrawTextW		1
DrawTextEx	DrawTextExW		1
EditStreamSetInfo	EditStreamSetInfoW		1
EditStreamSetName	EditStreamSetNameW		1
EncryptFile	EncryptFileW		1
EndUpdateResource	EndUpdateResourceW		1
EnumCalendarInfo	EnumCalendarInfoW		1
EnumCalendarInfoEx	EnumCalendarInfoExW		1
EnumDateFormats	EnumDateFormatsW		1
EnumDateFormatsEx	EnumDateFormatsExW		1
EnumDependentServices	EnumDependentServicesW		1
EnumDesktops	EnumDesktopsW		1
EnumDisplayDevices	EnumDisplayDevicesW		1
EnumDisplaySettings	EnumDisplaySettingsW		1
EnumDisplaySettingsEx	EnumDisplaySettingsExW		1
EnumFontFamilies	EnumFontFamiliesW		1
EnumFontFamiliesEx	EnumFontFamiliesExW		1
EnumFonts	EnumFontsW		1
EnumForms	EnumFormsW		1
EnumICMProfiles	EnumICMProfilesW		1
EnumJobs	EnumJobsW		1
EnumLanguageGroupLocales	EnumLanguageGroupLocalesW		1
EnumMonitors	EnumMonitorsW		1
EnumPageFiles	EnumPageFilesW		1
EnumPorts	EnumPortsW		1
EnumPrintProcessorDatatypes	EnumPrintProcessorDatatypesW		1
EnumPrintProcessors	EnumPrintProcessorsW		1
EnumPrinterData	EnumPrinterDataW		1
EnumPrinterDataEx	EnumPrinterDataExW		1
EnumPrinterDrivers	EnumPrinterDriversW		1
EnumPrinterKey	EnumPrinterKeyW		1
EnumPrinters	EnumPrintersW		1
EnumProps	EnumPropsW		1
EnumPropsEx	EnumPropsExW		1
EnumProtocols	EnumProtocolsW		1
EnumResourceLanguages	EnumResourceLanguagesW		1
EnumResourceLanguagesEx	EnumResourceLanguagesExW		1
EnumResourceNames	EnumResourceNamesW		1
EnumResourceNamesEx	EnumResourceNamesExW		1
EnumResourceTypes	EnumResourceTypesW		1
EnumResourceTypesEx	EnumResourceTypesExW		1
EnumServicesStatus	EnumServicesStatusW		1
EnumServicesStatusEx	EnumServicesStatusExW		1
EnumSystemCodePages	EnumSystemCodePagesW		1
EnumSystemLanguageGroups	EnumSystemLanguageGroupsW		1
EnumSystemLocales	EnumSystemLocalesW		1
EnumTimeFormats	EnumTimeFormatsW		1
EnumUILanguages	EnumUILanguagesW		1
EnumWindowStations	EnumWindowStationsW		1
EnumerateSecurityPackages	EnumerateSecurityPackagesW		1
ExpandEnvironmentStrings	ExpandEnvironmentStringsW		1
ExpandEnvironmentStringsForUser	ExpandEnvironmentStringsForUserW		1
ExtTextOut	ExtTextOutW		1
ExtractAssociatedIcon	ExtractAssociatedIconW		1
ExtractAssociatedIconEx	ExtractAssociatedIconExW		1
ExtractIcon	ExtractIconW		1
ExtractIconEx	ExtractIconExW		1
FMTID_NULL	GUID_NULL		1
FatalAppExit	FatalAppExitW		1
FileEncryptionStatus	FileEncryptionStatusW		1
FillConsoleOutputCharacter	FillConsoleOutputCharacterW		1
FindActCtxSectionString	FindActCtxSectionStringW		1
FindAtom	FindAtomW		1
FindExecutable	FindExecutableW		1
FindFirstChangeNotification	FindFirstChangeNotificationW		1
FindFirstFile	FindFirstFileW		1
FindFirstFileEx	FindFirstFileExW		1
FindFirstUrlCacheEntry	FindFirstUrlCacheEntryW		1
FindFirstUrlCacheEntryEx	FindFirstUrlCacheEntryExW		1
FindFirstVolume	FindFirstVolumeW		1
FindFirstVolumeMountPoint	FindFirstVolumeMountPointW		1
FindNextFile	FindNextFileW		1
FindNextUrlCacheEntry	FindNextUrlCacheEntryW		1
FindNextUrlCacheEntryEx	FindNextUrlCacheEntryExW		1
FindNextVolume	FindNextVolumeW		1
FindNextVolumeMountPoint	FindNextVolumeMountPointW		1
FindResource	FindResourceW		1
FindResourceEx	FindResourceExW		1
FindText	FindTextW		1
FindWindow	FindWindowW		1
FindWindowEx	FindWindowExW		1
FlatSB_GetScrollPropPtr	FlatSB_GetScrollProp		1
FlatSB_SetScrollPropPtr	FlatSB_SetScrollProp		1
FloppyClassGuid	GUID_DEVINTERFACE_FLOPPY		1
FoldString	FoldStringW		1
FormatMessage	FormatMessageW		1
FreeCredentialHandle	FreeCredentialsHandle		1
FreeEnvironmentStrings	FreeEnvironmentStringsW		1
FreeGPOList	FreeGPOListW		1
FtpCommand	FtpCommandW		1
FtpCreateDirectory	FtpCreateDirectoryW		1
FtpDeleteFile	FtpDeleteFileW		1
FtpFindFirstFile	FtpFindFirstFileW		1
FtpGetCurrentDirectory	FtpGetCurrentDirectoryW		1
FtpGetFile	FtpGetFileW		1
FtpOpenFile	FtpOpenFileW		1
FtpPutFile	FtpPutFileW		1
FtpRemoveDirectory	FtpRemoveDirectoryW		1
FtpRenameFile	FtpRenameFileW		1
FtpSetCurrentDirectory	FtpSetCurrentDirectoryW		1
GUID_CLASS_COMPORT	GUID_DEVINTERFACE_COMPORT		1
GUID_SERENUM_BUS_ENUMERATOR	GUID_DEVINTERFACE_SERENUM_BUS_ENUMERATOR		1
GetAddressByName	GetAddressByNameW		1
GetAllUsersProfileDirectory	GetAllUsersProfileDirectoryW		1
GetAltTabInfo	GetAltTabInfoW		1
GetAppliedGPOList	GetAppliedGPOListW		1
GetAtomName	GetAtomNameW		1
GetBinaryType	GetBinaryTypeW		1
GetCPInfoEx	GetCPInfoExW		1
GetCalendarInfo	GetCalendarInfoW		1
GetCharABCWidths	GetCharABCWidthsW		1
GetCharABCWidthsFloat	GetCharABCWidthsFloatW		1
GetCharWidth	GetCharWidthW		1
GetCharWidth32	GetCharWidth32W		1
GetCharWidthFloat	GetCharWidthFloatW		1
GetCharacterPlacement	GetCharacterPlacementW		1
GetClassInfo	GetClassInfoW		1
GetClassInfoEx	GetClassInfoExW		1
GetClassLong	GetClassLongW		1
GetClassLongPtr	GetClassLongW		1
GetClassLongPtrA	GetClassLongA		1
GetClassLongPtrW	GetClassLongW		1
GetClassName	GetClassNameW		1
GetClipboardFormatName	GetClipboardFormatNameW		1
GetCommandLine	GetCommandLineW		1
GetCompressedFileSize	GetCompressedFileSizeW		1
GetComputerName	GetComputerNameW		1
GetComputerNameEx	GetComputerNameExW		1
GetConsoleAlias	GetConsoleAliasW		1
GetConsoleAliasExes	GetConsoleAliasExesW		1
GetConsoleAliasExesLength	GetConsoleAliasExesLengthW		1
GetConsoleAliases	GetConsoleAliasesW		1
GetConsoleAliasesLength	GetConsoleAliasesLengthW		1
GetConsoleTitle	GetConsoleTitleW		1
GetCurrencyFormat	GetCurrencyFormatW		1
GetCurrentDirectory	GetCurrentDirectoryW		1
GetCurrentHwProfile	GetCurrentHwProfileW		1
GetDateFormat	GetDateFormatW		1
GetDefaultCommConfig	GetDefaultCommConfigW		1
GetDefaultPrinter	GetDefaultPrinterW		1
GetDefaultUserProfileDirectory	GetDefaultUserProfileDirectoryW		1
GetDeviceDriverBaseName	GetDeviceDriverBaseNameW		1
GetDeviceDriverFileName	GetDeviceDriverFileNameW		1
GetDiskFreeSpace	GetDiskFreeSpaceW		1
GetDiskFreeSpaceEx	GetDiskFreeSpaceExW		1
GetDlgItemText	GetDlgItemTextW		1
GetDriveType	GetDriveTypeW		1
GetEnhMetaFile	GetEnhMetaFileW		1
GetEnhMetaFileDescription	GetEnhMetaFileDescriptionW		1
GetEnvironmentStrings	GetEnvironmentStringsW		1
GetEnvironmentVariable	GetEnvironmentVariableW		1
GetExceptionCode	_exception_code		1
GetExpandedName	GetExpandedNameW		1
GetFileAttributes	GetFileAttributesW		1
GetFileAttributesEx	GetFileAttributesExW		1
GetFileSecurity	GetFileSecurityW		1
GetFileTitle	GetFileTitleW		1
GetFileVersionInfo	GetFileVersionInfoW		1
GetFileVersionInfoEx	GetFileVersionInfoExW		1
GetFileVersionInfoSize	GetFileVersionInfoSizeW		1
GetFileVersionInfoSizeEx	GetFileVersionInfoSizeExW		1
GetFirmwareEnvironmentVariable	GetFirmwareEnvironmentVariableW		1
GetForm	GetFormW		1
GetFullPathName	GetFullPathNameW		1
GetGPOList	GetGPOListW		1
GetGeoInfo	GetGeoInfoW		1
GetGlyphIndices	GetGlyphIndicesW		1
GetGlyphOutline	GetGlyphOutlineW		1
GetICMProfile	GetICMProfileW		1
GetJob	GetJobW		1
GetKerningPairs	GetKerningPairsW		1
GetKeyNameText	GetKeyNameTextW		1
GetKeyboardLayoutName	GetKeyboardLayoutNameW		1
GetLocaleInfo	GetLocaleInfoW		1
GetLogColorSpace	GetLogColorSpaceW		1
GetLogicalDriveStrings	GetLogicalDriveStringsW		1
GetLongPathName	GetLongPathNameW		1
GetMappedFileName	GetMappedFileNameW		1
GetMenuItemInfo	GetMenuItemInfoW		1
GetMenuString	GetMenuStringW		1
GetMessage	GetMessageW		1
GetMetaFile	GetMetaFileW		1
GetModuleBaseName	GetModuleBaseNameW		1
GetModuleFileName	GetModuleFileNameW		1
GetModuleFileNameEx	GetModuleFileNameExW		1
GetModuleHandle	GetModuleHandleW		1
GetModuleHandleEx	GetModuleHandleExW		1
GetMonitorInfo	GetMonitorInfoW		1
GetNameByType	GetNameByTypeW		1
GetNamedPipeClientComputerName	GetNamedPipeClientComputerNameW		1
GetNamedPipeHandleState	GetNamedPipeHandleStateW		1
GetNumberFormat	GetNumberFormatW		1
GetObject	GetObjectW		1
GetOpenCardName	GetOpenCardNameW		1
GetOpenFileName	GetOpenFileNameW		1
GetOpenFileNamePreview	GetOpenFileNamePreviewW		1
GetOutlineTextMetrics	GetOutlineTextMetricsW		1
GetPrintProcessorDirectory	GetPrintProcessorDirectoryW		1
GetPrinter	GetPrinterW		1
GetPrinterData	GetPrinterDataW		1
GetPrinterDataEx	GetPrinterDataExW		1
GetPrinterDriver	GetPrinterDriverW		1
GetPrinterDriverDirectory	GetPrinterDriverDirectoryW		1
GetPrivateProfileInt	GetPrivateProfileIntW		1
GetPrivateProfileSection	GetPrivateProfileSectionW		1
GetPrivateProfileSectionNames	GetPrivateProfileSectionNamesW		1
GetPrivateProfileString	GetPrivateProfileStringW		1
GetPrivateProfileStruct	GetPrivateProfileStructW		1
GetProcessImageFileName	GetProcessImageFileNameW		1
GetProfileInt	GetProfileIntW		1
GetProfileSection	GetProfileSectionW		1
GetProfileString	GetProfileStringW		1
GetProfilesDirectory	GetProfilesDirectoryW		1
GetProp	GetPropW		1
GetRawInputDeviceInfo	GetRawInputDeviceInfoW		1
GetRoleText	GetRoleTextW		1
GetSaveFileName	GetSaveFileNameW		1
GetSaveFileNamePreview	GetSaveFileNamePreviewW		1
GetService	GetServiceW		1
GetServiceDisplayName	GetServiceDisplayNameW		1
GetServiceKeyName	GetServiceKeyNameW		1
GetShortPathName	GetShortPathNameW		1
GetStartupInfo	GetStartupInfoW		1
GetStateText	GetStateTextW		1
GetStringTypeEx	GetStringTypeExW		1
GetSystemDirectory	GetSystemDirectoryW		1
GetSystemWindowsDirectory	GetSystemWindowsDirectoryW		1
GetSystemWow64Directory	GetSystemWow64DirectoryW		1
GetTabbedTextExtent	GetTabbedTextExtentW		1
GetTempFileName	GetTempFileNameW		1
GetTempPath	GetTempPathW		1
GetTextExtentExPoint	GetTextExtentExPointW		1
GetTextExtentPoint	GetTextExtentPointW		1
GetTextExtentPoint32	GetTextExtentPoint32W		1
GetTextFace	GetTextFaceW		1
GetTextMetrics	GetTextMetricsW		1
GetTimeFormat	GetTimeFormatW		1
GetTypeByName	GetTypeByNameW		1
GetUrlCacheEntryInfo	GetUrlCacheEntryInfoW		1
GetUrlCacheEntryInfoEx	GetUrlCacheEntryInfoExW		1
GetUrlCacheGroupAttribute	GetUrlCacheGroupAttributeW		1
GetUserName	GetUserNameW		1
GetUserObjectInformation	GetUserObjectInformationW		1
GetUserProfileDirectory	GetUserProfileDirectoryW		1
GetVersionEx	GetVersionExW		1
GetVolumeInformation	GetVolumeInformationW		1
GetVolumeNameForVolumeMountPoint	GetVolumeNameForVolumeMountPointW		1
GetVolumePathName	GetVolumePathNameW		1
GetVolumePathNamesForVolumeName	GetVolumePathNamesForVolumeNameW		1
GetWindowLong	GetWindowLongW		1
GetWindowLongPtr	GetWindowLongW		1
GetWindowLongPtrA	GetWindowLongA		1
GetWindowLongPtrW	GetWindowLongW		1
GetWindowModuleFileName	GetWindowModuleFileNameW		1
GetWindowText	GetWindowTextW		1
GetWindowTextLength	GetWindowTextLengthW		1
GetWindowsDirectory	GetWindowsDirectoryW		1
GlobalAddAtom	GlobalAddAtomW		1
GlobalFindAtom	GlobalFindAtomW		1
GlobalGetAtomName	GlobalGetAtomNameW		1
GopherCreateLocator	GopherCreateLocatorW		1
GopherFindFirstFile	GopherFindFirstFileW		1
GopherGetAttribute	GopherGetAttributeW		1
GopherGetLocatorType	GopherGetLocatorTypeW		1
GopherOpenFile	GopherOpenFileW		1
GrayString	GrayStringW		1
HUGE_VAL	_HUGE		1
HiddenVolumeClassGuid	GUID_DEVINTERFACE_HIDDEN_VOLUME		1
HtmlHelp	HtmlHelpW		1
HttpAddRequestHeaders	HttpAddRequestHeadersW		1
HttpEndRequest	HttpEndRequestW		1
HttpOpenRequest	HttpOpenRequestW		1
HttpQueryInfo	HttpQueryInfoW		1
HttpSendRequest	HttpSendRequestW		1
HttpSendRequestEx	HttpSendRequestExW		1
IID_IEnumCATID	IID_IEnumGUID		1
IID_IEnumCLSID	IID_IEnumGUID		1
IID_IEnumMsoView	IID_IEnumOleDocumentViews		1
IID_IExtractIcon	IID_IExtractIconW		1
IID_IFileViewer	IID_IFileViewerW		1
IID_IHlinkSource	IID_IHlinkTarget		1
IID_IMsoCommandTarget	IID_IOleCommandTarget		1
IID_IMsoDocument	IID_IOleDocument		1
IID_IMsoDocumentSite	IID_IOleDocumentSite		1
IID_IMsoView	IID_IOleDocumentView		1
IID_INewShortcutHook	IID_INewShortcutHookW		1
IID_IOInet	IID_IInternet		1
IID_IOInetBindInfo	IID_IInternetBindInfo		1
IID_IOInetBindInfoEx	IID_IInternetBindInfoEx		1
IID_IOInetPriority	IID_IInternetPriority		1
IID_IOInetProtocol	IID_IInternetProtocol		1
IID_IOInetProtocolInfo	IID_IInternetProtocolInfo		1
IID_IOInetProtocolRoot	IID_IInternetProtocolRoot		1
IID_IOInetProtocolSink	IID_IInternetProtocolSink		1
IID_IOInetProtocolSinkStackable	IID_IInternetProtocolSinkStackable		1
IID_IOInetSession	IID_IInternetSession		1
IID_IOInetThreadSwitch	IID_IInternetThreadSwitch		1
IID_IShellCopyHook	IID_ICopyHookW		1
IID_IShellCopyHookA	IID_ICopyHookA		1
IID_IShellCopyHookW	IID_ICopyHookW		1
IID_IShellExecuteHook	IID_IShellExecuteHookW		1
IID_IShellLink	IID_IShellLinkW		1
IID_IUniformResourceLocator	IID_IUniformResourceLocatorW		1
IID_NULL	GUID_NULL		1
ILCloneChild	ILCloneFirst		1
ILCloneFull	ILClone		1
ILCreateFromPath	ILCreateFromPathW		1
I_RpcBindingInqDynamicEndpoint	I_RpcBindingInqDynamicEndpointW		1
I_RpcNsBindingSetEntryName	I_RpcNsBindingSetEntryNameW		1
I_RpcServerUnregisterEndpoint	I_RpcServerUnregisterEndpointW		1
I_RpcServerUseProtseq2	I_RpcServerUseProtseq2W		1
I_RpcServerUseProtseqEp2	I_RpcServerUseProtseqEp2W		1
ImageList_LoadImage	ImageList_LoadImageW		1
ImmConfigureIME	ImmConfigureIMEW		1
ImmEnumRegisterWord	ImmEnumRegisterWordW		1
ImmEscape	ImmEscapeW		1
ImmGetCandidateList	ImmGetCandidateListW		1
ImmGetCandidateListCount	ImmGetCandidateListCountW		1
ImmGetCompositionFont	ImmGetCompositionFontW		1
ImmGetCompositionString	ImmGetCompositionStringW		1
ImmGetConversionList	ImmGetConversionListW		1
ImmGetDescription	ImmGetDescriptionW		1
ImmGetGuideLine	ImmGetGuideLineW		1
ImmGetIMEFileName	ImmGetIMEFileNameW		1
ImmGetImeMenuItems	ImmGetImeMenuItemsW		1
ImmGetRegisterWordStyle	ImmGetRegisterWordStyleW		1
ImmInstallIME	ImmInstallIMEW		1
ImmIsUIMessage	ImmIsUIMessageW		1
ImmRegisterWord	ImmRegisterWordW		1
ImmSetCompositionFont	ImmSetCompositionFontW		1
ImmSetCompositionString	ImmSetCompositionStringW		1
ImmUnregisterWord	ImmUnregisterWordW		1
ImportSecurityContext	ImportSecurityContextW		1
InitSecurityInterface	InitSecurityInterfaceW		1
InitializeSecurityContext	InitializeSecurityContextW		1
InitiateShutdown	InitiateShutdownW		1
InitiateSystemShutdown	InitiateSystemShutdownW		1
InitiateSystemShutdownEx	InitiateSystemShutdownExW		1
InsertMenu	InsertMenuW		1
InsertMenuItem	InsertMenuItemW		1
InstallHinfSection	InstallHinfSectionW		1
InterlockedAnd16	_InterlockedAnd16		1
InterlockedBitTestAndReset	_interlockedbittestandreset		1
InterlockedBitTestAndSet	_interlockedbittestandset		1
InterlockedCompareExchange16	_InterlockedCompareExchange16		1
InterlockedCompareExchangeAcquire	InterlockedCompareExchange		1
InterlockedCompareExchangeRelease	InterlockedCompareExchange		1
InterlockedDecrementAcquire	InterlockedDecrement		1
InterlockedDecrementRelease	InterlockedDecrement		1
InterlockedIncrementAcquire	InterlockedIncrement		1
InterlockedIncrementRelease	InterlockedIncrement		1
InterlockedOr16	_InterlockedOr16		1
InternetCanonicalizeUrl	InternetCanonicalizeUrlW		1
InternetCheckConnection	InternetCheckConnectionW		1
InternetCombineUrl	InternetCombineUrlW		1
InternetConfirmZoneCrossing	InternetConfirmZoneCrossingW		1
InternetConnect	InternetConnectW		1
InternetCrackUrl	InternetCrackUrlW		1
InternetCreateUrl	InternetCreateUrlW		1
InternetDial	InternetDialW		1
InternetEnumPerSiteCookieDecision	InternetEnumPerSiteCookieDecisionW		1
InternetFindNextFile	InternetFindNextFileW		1
InternetGetConnectedStateEx	InternetGetConnectedStateExW		1
InternetGetCookie	InternetGetCookieW		1
InternetGetCookieEx	InternetGetCookieExW		1
InternetGetLastResponseInfo	InternetGetLastResponseInfoW		1
InternetGetPerSiteCookieDecision	InternetGetPerSiteCookieDecisionW		1
InternetGoOnline	InternetGoOnlineW		1
InternetOpen	InternetOpenW		1
InternetOpenUrl	InternetOpenUrlW		1
InternetQueryOption	InternetQueryOptionW		1
InternetReadFileEx	InternetReadFileExW		1
InternetSetCookie	InternetSetCookieW		1
InternetSetCookieEx	InternetSetCookieExW		1
InternetSetDialState	InternetSetDialStateW		1
InternetSetOption	InternetSetOptionW		1
InternetSetOptionEx	InternetSetOptionExW		1
InternetSetPerSiteCookieDecision	InternetSetPerSiteCookieDecisionW		1
InternetSetStatusCallback	InternetSetStatusCallbackW		1
InternetTimeFromSystemTime	InternetTimeFromSystemTimeW		1
InternetTimeToSystemTime	InternetTimeToSystemTimeW		1
IsBadStringPtr	IsBadStringPtrW		1
IsCharAlpha	IsCharAlphaW		1
IsCharAlphaNumeric	IsCharAlphaNumericW		1
IsCharLower	IsCharLowerW		1
IsCharUpper	IsCharUpperW		1
IsDialogMessage	IsDialogMessageW		1
IsLFNDrive	IsLFNDriveW		1
IsLoggingEnabled	IsLoggingEnabledW		1
LCMapString	LCMapStringW		1
LZOpenFile	LZOpenFileW		1
LoadAccelerators	LoadAcceleratorsW		1
LoadBitmap	LoadBitmapW		1
LoadCursor	LoadCursorW		1
LoadCursorFromFile	LoadCursorFromFileW		1
LoadIcon	LoadIconW		1
LoadImage	LoadImageW		1
LoadKeyboardLayout	LoadKeyboardLayoutW		1
LoadLibrary	LoadLibraryW		1
LoadLibraryEx	LoadLibraryExW		1
LoadMenu	LoadMenuW		1
LoadMenuIndirect	LoadMenuIndirectW		1
LoadString	LoadStringW		1
LoadUserProfile	LoadUserProfileW		1
LogonUser	LogonUserW		1
LogonUserEx	LogonUserExW		1
LookupAccountName	LookupAccountNameW		1
LookupAccountNameLocal	LookupAccountNameLocalW		1
LookupAccountSid	LookupAccountSidW		1
LookupAccountSidLocal	LookupAccountSidLocalW		1
LookupPrivilegeDisplayName	LookupPrivilegeDisplayNameW		1
LookupPrivilegeName	LookupPrivilegeNameW		1
LookupPrivilegeValue	LookupPrivilegeValueW		1
MCIWndCreate	MCIWndCreateW		1
MCIWndSM	SendMessageW		1
MapFileAndCheckSum	MapFileAndCheckSumW		1
MapVirtualKey	MapVirtualKeyW		1
MapVirtualKeyEx	MapVirtualKeyExW		1
MediumChangerClassGuid	GUID_DEVINTERFACE_MEDIUMCHANGER		1
MessageBox	MessageBoxW		1
MessageBoxEx	MessageBoxExW		1
MessageBoxIndirect	MessageBoxIndirectW		1
ModifyMenu	ModifyMenuW		1
Module32First	Module32FirstW		1
Module32Next	Module32NextW		1
MoveFile	MoveFileW		1
MoveFileEx	MoveFileExW		1
MoveFileWithProgress	MoveFileWithProgressW		1
MsiAdvertiseProduct	MsiAdvertiseProductW		1
MsiAdvertiseProductEx	MsiAdvertiseProductExW		1
MsiAdvertiseScript	MsiAdvertiseScriptW		1
MsiApplyPatch	MsiApplyPatchW		1
MsiCollectUserInfo	MsiCollectUserInfoW		1
MsiConfigureFeature	MsiConfigureFeatureW		1
MsiConfigureProduct	MsiConfigureProductW		1
MsiConfigureProductEx	MsiConfigureProductExW		1
MsiEnableLog	MsiEnableLogW		1
MsiEnumClients	MsiEnumClientsW		1
MsiEnumComponentQualifiers	MsiEnumComponentQualifiersW		1
MsiEnumComponents	MsiEnumComponentsW		1
MsiEnumFeatures	MsiEnumFeaturesW		1
MsiEnumPatches	MsiEnumPatchesW		1
MsiEnumProducts	MsiEnumProductsW		1
MsiEnumRelatedProducts	MsiEnumRelatedProductsW		1
MsiGetComponentPath	MsiGetComponentPathW		1
MsiGetFeatureInfo	MsiGetFeatureInfoW		1
MsiGetFeatureUsage	MsiGetFeatureUsageW		1
MsiGetFileHash	MsiGetFileHashW		1
MsiGetFileSignatureInformation	MsiGetFileSignatureInformationW		1
MsiGetFileVersion	MsiGetFileVersionW		1
MsiGetPatchInfo	MsiGetPatchInfoW		1
MsiGetProductCode	MsiGetProductCodeW		1
MsiGetProductInfo	MsiGetProductInfoW		1
MsiGetProductInfoFromScript	MsiGetProductInfoFromScriptW		1
MsiGetProductProperty	MsiGetProductPropertyW		1
MsiGetShortcutTarget	MsiGetShortcutTargetW		1
MsiGetUserInfo	MsiGetUserInfoW		1
MsiInstallMissingComponent	MsiInstallMissingComponentW		1
MsiInstallMissingFile	MsiInstallMissingFileW		1
MsiInstallProduct	MsiInstallProductW		1
MsiIsProductElevated	MsiIsProductElevatedW		1
MsiLocateComponent	MsiLocateComponentW		1
MsiOpenPackage	MsiOpenPackageW		1
MsiOpenPackageEx	MsiOpenPackageExW		1
MsiOpenProduct	MsiOpenProductW		1
MsiProcessAdvertiseScript	MsiProcessAdvertiseScriptW		1
MsiProvideAssembly	MsiProvideAssemblyW		1
MsiProvideComponent	MsiProvideComponentW		1
MsiProvideQualifiedComponent	MsiProvideQualifiedComponentW		1
MsiProvideQualifiedComponentEx	MsiProvideQualifiedComponentExW		1
MsiQueryFeatureState	MsiQueryFeatureStateW		1
MsiQueryProductState	MsiQueryProductStateW		1
MsiReinstallFeature	MsiReinstallFeatureW		1
MsiReinstallProduct	MsiReinstallProductW		1
MsiSetExternalUI	MsiSetExternalUIW		1
MsiSourceListAddSource	MsiSourceListAddSourceW		1
MsiSourceListClearAll	MsiSourceListClearAllW		1
MsiSourceListForceResolution	MsiSourceListForceResolutionW		1
MsiUseFeature	MsiUseFeatureW		1
MsiUseFeatureEx	MsiUseFeatureExW		1
MsiVerifyPackage	MsiVerifyPackageW		1
MultinetGetConnectionPerformance	MultinetGetConnectionPerformanceW		1
OInetCombineUrl	CoInternetCombineUrl		1
OInetCompareUrl	CoInternetCompareUrl		1
OInetGetSession	CoInternetGetSession		1
OInetParseUrl	CoInternetParseUrl		1
OInetQueryInfo	CoInternetQueryInfo		1
ObjectCloseAuditAlarm	ObjectCloseAuditAlarmW		1
ObjectDeleteAuditAlarm	ObjectDeleteAuditAlarmW		1
ObjectOpenAuditAlarm	ObjectOpenAuditAlarmW		1
ObjectPrivilegeAuditAlarm	ObjectPrivilegeAuditAlarmW		1
OemToAnsi	OemToCharA		1
OemToAnsiBuff	OemToCharBuffA		1
OemToChar	OemToCharW		1
OemToCharBuff	OemToCharBuffW		1
OpenBackupEventLog	OpenBackupEventLogW		1
OpenDesktop	OpenDesktopW		1
OpenEncryptedFileRaw	OpenEncryptedFileRawW		1
OpenEvent	OpenEventW		1
OpenEventLog	OpenEventLogW		1
OpenFileMapping	OpenFileMappingW		1
OpenJobObject	OpenJobObjectW		1
OpenMutex	OpenMutexW		1
OpenPrinter	OpenPrinterW		1
OpenSCManager	OpenSCManagerW		1
OpenSemaphore	OpenSemaphoreW		1
OpenService	OpenServiceW		1
OpenWaitableTimer	OpenWaitableTimerW		1
OpenWindowStation	OpenWindowStationW		1
OutputDebugString	OutputDebugStringW		1
PSTMSG	PostMessageW		1
PageSetupDlg	PageSetupDlgW		1
ParseURL	ParseURLW		1
PartitionClassGuid	GUID_DEVINTERFACE_PARTITION		1
PathAddBackslash	PathAddBackslashW		1
PathAddExtension	PathAddExtensionW		1
PathAppend	PathAppendW		1
PathBuildRoot	PathBuildRootW		1
PathCanonicalize	PathCanonicalizeW		1
PathCombine	PathCombineW		1
PathCommonPrefix	PathCommonPrefixW		1
PathCompactPath	PathCompactPathW		1
PathCompactPathEx	PathCompactPathExW		1
PathCreateFromUrl	PathCreateFromUrlW		1
PathFileExists	PathFileExistsW		1
PathFindExtension	PathFindExtensionW		1
PathFindFileName	PathFindFileNameW		1
PathFindNextComponent	PathFindNextComponentW		1
PathFindOnPath	PathFindOnPathW		1
PathFindSuffixArray	PathFindSuffixArrayW		1
PathGetArgs	PathGetArgsW		1
PathGetCharType	PathGetCharTypeW		1
PathGetDriveNumber	PathGetDriveNumberW		1
PathIsContentType	PathIsContentTypeW		1
PathIsDirectory	PathIsDirectoryW		1
PathIsDirectoryEmpty	PathIsDirectoryEmptyW		1
PathIsFileSpec	PathIsFileSpecW		1
PathIsLFNFileSpec	PathIsLFNFileSpecW		1
PathIsNetworkPath	PathIsNetworkPathW		1
PathIsPrefix	PathIsPrefixW		1
PathIsRelative	PathIsRelativeW		1
PathIsRoot	PathIsRootW		1
PathIsSameRoot	PathIsSameRootW		1
PathIsSlow	PathIsSlowW		1
PathIsSystemFolder	PathIsSystemFolderW		1
PathIsUNC	PathIsUNCW		1
PathIsUNCServer	PathIsUNCServerW		1
PathIsUNCServerShare	PathIsUNCServerShareW		1
PathIsURL	PathIsURLW		1
PathMakePretty	PathMakePrettyW		1
PathMakeSystemFolder	PathMakeSystemFolderW		1
PathMatchSpec	PathMatchSpecW		1
PathParseIconLocation	PathParseIconLocationW		1
PathQuoteSpaces	PathQuoteSpacesW		1
PathRelativePathTo	PathRelativePathToW		1
PathRemoveArgs	PathRemoveArgsW		1
PathRemoveBackslash	PathRemoveBackslashW		1
PathRemoveBlanks	PathRemoveBlanksW		1
PathRemoveExtension	PathRemoveExtensionW		1
PathRemoveFileSpec	PathRemoveFileSpecW		1
PathRenameExtension	PathRenameExtensionW		1
PathSearchAndQualify	PathSearchAndQualifyW		1
PathSetDlgItemPath	PathSetDlgItemPathW		1
PathSkipRoot	PathSkipRootW		1
PathStripPath	PathStripPathW		1
PathStripToRoot	PathStripToRootW		1
PathUnExpandEnvStrings	PathUnExpandEnvStringsW		1
PathUndecorate	PathUndecorateW		1
PathUnmakeSystemFolder	PathUnmakeSystemFolderW		1
PathUnquoteSpaces	PathUnquoteSpacesW		1
PdhAddCounter	PdhAddCounterW		1
PdhBindInputDataSource	PdhBindInputDataSourceW		1
PdhBrowseCounters	PdhBrowseCountersW		1
PdhBrowseCountersH	PdhBrowseCountersHW		1
PdhConnectMachine	PdhConnectMachineW		1
PdhCreateSQLTables	PdhCreateSQLTablesW		1
PdhEnumLogSetNames	PdhEnumLogSetNamesW		1
PdhEnumMachines	PdhEnumMachinesW		1
PdhEnumMachinesH	PdhEnumMachinesHW		1
PdhEnumObjectItems	PdhEnumObjectItemsW		1
PdhEnumObjectItemsH	PdhEnumObjectItemsHW		1
PdhEnumObjects	PdhEnumObjectsW		1
PdhEnumObjectsH	PdhEnumObjectsHW		1
PdhExpandCounterPath	PdhExpandCounterPathW		1
PdhExpandWildCardPath	PdhExpandWildCardPathW		1
PdhExpandWildCardPathH	PdhExpandWildCardPathHW		1
PdhGetCounterInfo	PdhGetCounterInfoW		1
PdhGetDataSourceTimeRange	PdhGetDataSourceTimeRangeW		1
PdhGetDefaultPerfCounter	PdhGetDefaultPerfCounterW		1
PdhGetDefaultPerfCounterH	PdhGetDefaultPerfCounterHW		1
PdhGetDefaultPerfObject	PdhGetDefaultPerfObjectW		1
PdhGetDefaultPerfObjectH	PdhGetDefaultPerfObjectHW		1
PdhGetFormattedCounterArray	PdhGetFormattedCounterArrayW		1
PdhGetRawCounterArray	PdhGetRawCounterArrayW		1
PdhLookupPerfIndexByName	PdhLookupPerfIndexByNameW		1
PdhLookupPerfNameByIndex	PdhLookupPerfNameByIndexW		1
PdhMakeCounterPath	PdhMakeCounterPathW		1
PdhOpenLog	PdhOpenLogW		1
PdhOpenQuery	PdhOpenQueryW		1
PdhParseCounterPath	PdhParseCounterPathW		1
PdhParseInstanceName	PdhParseInstanceNameW		1
PdhSelectDataSource	PdhSelectDataSourceW		1
PdhUpdateLog	PdhUpdateLogW		1
PdhValidatePath	PdhValidatePathW		1
PdhVerifySQLDB	PdhVerifySQLDBW		1
PeekConsoleInput	PeekConsoleInputW		1
PeekMessage	PeekMessageW		1
PlaySound	PlaySoundW		1
PolyTextOut	PolyTextOutW		1
PostMessage	PostMessageW		1
PostThreadMessage	PostThreadMessageW		1
PrintDlg	PrintDlgW		1
PrintDlgEx	PrintDlgExW		1
PrinterMessageBox	PrinterMessageBoxW		1
PrivateExtractIcons	PrivateExtractIconsW		1
PrivilegedServiceAuditAlarm	PrivilegedServiceAuditAlarmW		1
Process32First	Process32FirstW		1
Process32Next	Process32NextW		1
PropertySheet	PropertySheetW		1
QueryContextAttributes	QueryContextAttributesW		1
QueryCredentialsAttributes	QueryCredentialsAttributesW		1
QueryDosDevice	QueryDosDeviceW		1
QuerySecurityPackageInfo	QuerySecurityPackageInfoW		1
QueryServiceConfig	QueryServiceConfigW		1
QueryServiceConfig2	QueryServiceConfig2W		1
QueryServiceLockStatus	QueryServiceLockStatusW		1
RasConnectionNotification	RasConnectionNotificationW		1
RasCreatePhonebookEntry	RasCreatePhonebookEntryW		1
RasDeleteEntry	RasDeleteEntryW		1
RasDeleteSubEntry	RasDeleteSubEntryW		1
RasDial	RasDialW		1
RasEditPhonebookEntry	RasEditPhonebookEntryW		1
RasEnumAutodialAddresses	RasEnumAutodialAddressesW		1
RasEnumConnections	RasEnumConnectionsW		1
RasEnumDevices	RasEnumDevicesW		1
RasEnumEntries	RasEnumEntriesW		1
RasFreeEapUserIdentity	RasFreeEapUserIdentityW		1
RasGetAutodialAddress	RasGetAutodialAddressW		1
RasGetAutodialEnable	RasGetAutodialEnableW		1
RasGetAutodialParam	RasGetAutodialParamW		1
RasGetConnectStatus	RasGetConnectStatusW		1
RasGetCountryInfo	RasGetCountryInfoW		1
RasGetCredentials	RasGetCredentialsW		1
RasGetCustomAuthData	RasGetCustomAuthDataW		1
RasGetEapUserData	RasGetEapUserDataW		1
RasGetEapUserIdentity	RasGetEapUserIdentityW		1
RasGetEntryDialParams	RasGetEntryDialParamsW		1
RasGetEntryProperties	RasGetEntryPropertiesW		1
RasGetErrorString	RasGetErrorStringW		1
RasGetProjectionInfo	RasGetProjectionInfoW		1
RasGetSubEntryHandle	RasGetSubEntryHandleW		1
RasGetSubEntryProperties	RasGetSubEntryPropertiesW		1
RasHangUp	RasHangUpW		1
RasRenameEntry	RasRenameEntryW		1
RasSetAutodialAddress	RasSetAutodialAddressW		1
RasSetAutodialEnable	RasSetAutodialEnableW		1
RasSetAutodialParam	RasSetAutodialParamW		1
RasSetCredentials	RasSetCredentialsW		1
RasSetCustomAuthData	RasSetCustomAuthDataW		1
RasSetEapUserData	RasSetEapUserDataW		1
RasSetEntryDialParams	RasSetEntryDialParamsW		1
RasSetEntryProperties	RasSetEntryPropertiesW		1
RasSetSubEntryProperties	RasSetSubEntryPropertiesW		1
RasValidateEntryName	RasValidateEntryNameW		1
ReadConsole	ReadConsoleW		1
ReadConsoleInput	ReadConsoleInputW		1
ReadConsoleOutput	ReadConsoleOutputW		1
ReadConsoleOutputCharacter	ReadConsoleOutputCharacterW		1
ReadEventLog	ReadEventLogW		1
ReadPMC	__readpmc		1
RealGetWindowClass	RealGetWindowClassW		1
RegConnectRegistry	RegConnectRegistryW		1
RegConnectRegistryEx	RegConnectRegistryExW		1
RegCreateKey	RegCreateKeyW		1
RegCreateKeyEx	RegCreateKeyExW		1
RegCreateKeyTransacted	RegCreateKeyTransactedW		1
RegDeleteKey	RegDeleteKeyW		1
RegDeleteKeyEx	RegDeleteKeyExW		1
RegDeleteKeyTransacted	RegDeleteKeyTransactedW		1
RegDeleteValue	RegDeleteValueW		1
RegEnumKey	RegEnumKeyW		1
RegEnumKeyEx	RegEnumKeyExW		1
RegEnumValue	RegEnumValueW		1
RegLoadKey	RegLoadKeyW		1
RegOpenKey	RegOpenKeyW		1
RegOpenKeyEx	RegOpenKeyExW		1
RegOpenKeyTransacted	RegOpenKeyTransactedW		1
RegQueryInfoKey	RegQueryInfoKeyW		1
RegQueryMultipleValues	RegQueryMultipleValuesW		1
RegQueryValue	RegQueryValueW		1
RegQueryValueEx	RegQueryValueExW		1
RegReplaceKey	RegReplaceKeyW		1
RegRestoreKey	RegRestoreKeyW		1
RegSaveKey	RegSaveKeyW		1
RegSaveKeyEx	RegSaveKeyExW		1
RegSetValue	RegSetValueW		1
RegSetValueEx	RegSetValueExW		1
RegUnLoadKey	RegUnLoadKeyW		1
RegisterClass	RegisterClassW		1
RegisterClassEx	RegisterClassExW		1
RegisterClipboardFormat	RegisterClipboardFormatW		1
RegisterDeviceNotification	RegisterDeviceNotificationW		1
RegisterEventSource	RegisterEventSourceW		1
RegisterServiceCtrlHandler	RegisterServiceCtrlHandlerW		1
RegisterServiceCtrlHandlerEx	RegisterServiceCtrlHandlerExW		1
RegisterWindowMessage	RegisterWindowMessageW		1
RemoveDirectory	RemoveDirectoryW		1
RemoveFontResource	RemoveFontResourceW		1
RemoveFontResourceEx	RemoveFontResourceExW		1
RemoveProp	RemovePropW		1
ReplaceFile	ReplaceFileW		1
ReplaceText	ReplaceTextW		1
ReportEvent	ReportEventW		1
ResetDC	ResetDCW		1
ResetPrinter	ResetPrinterW		1
RetrieveUrlCacheEntryFile	RetrieveUrlCacheEntryFileW		1
RetrieveUrlCacheEntryStream	RetrieveUrlCacheEntryStreamW		1
RotateLeft32	_rotl		1
RotateLeft64	_rotl64		1
RotateRight32	_rotr		1
RotateRight64	_rotr64		1
RpcBindingFromStringBinding	RpcBindingFromStringBindingW		1
RpcBindingInqAuthClient	RpcBindingInqAuthClientW		1
RpcBindingInqAuthClientEx	RpcBindingInqAuthClientExW		1
RpcBindingInqAuthInfo	RpcBindingInqAuthInfoW		1
RpcBindingInqAuthInfoEx	RpcBindingInqAuthInfoExW		1
RpcBindingSetAuthInfo	RpcBindingSetAuthInfoW		1
RpcBindingSetAuthInfoEx	RpcBindingSetAuthInfoExW		1
RpcBindingToStringBinding	RpcBindingToStringBindingW		1
RpcEpRegister	RpcEpRegisterW		1
RpcEpRegisterNoReplace	RpcEpRegisterNoReplaceW		1
RpcMgmtEpEltInqNext	RpcMgmtEpEltInqNextW		1
RpcMgmtInqServerPrincName	RpcMgmtInqServerPrincNameW		1
RpcNetworkInqProtseqs	RpcNetworkInqProtseqsW		1
RpcNetworkIsProtseqValid	RpcNetworkIsProtseqValidW		1
RpcNsBindingExport	RpcNsBindingExportW		1
RpcNsBindingExportPnP	RpcNsBindingExportPnPW		1
RpcNsBindingImportBegin	RpcNsBindingImportBeginW		1
RpcNsBindingInqEntryName	RpcNsBindingInqEntryNameW		1
RpcNsBindingLookupBegin	RpcNsBindingLookupBeginW		1
RpcNsBindingUnexport	RpcNsBindingUnexportW		1
RpcNsBindingUnexportPnP	RpcNsBindingUnexportPnPW		1
RpcNsEntryExpandName	RpcNsEntryExpandNameW		1
RpcNsEntryObjectInqBegin	RpcNsEntryObjectInqBeginW		1
RpcNsGroupDelete	RpcNsGroupDeleteW		1
RpcNsGroupMbrAdd	RpcNsGroupMbrAddW		1
RpcNsGroupMbrInqBegin	RpcNsGroupMbrInqBeginW		1
RpcNsGroupMbrInqNext	RpcNsGroupMbrInqNextW		1
RpcNsGroupMbrRemove	RpcNsGroupMbrRemoveW		1
RpcNsMgmtBindingUnexport	RpcNsMgmtBindingUnexportW		1
RpcNsMgmtEntryCreate	RpcNsMgmtEntryCreateW		1
RpcNsMgmtEntryDelete	RpcNsMgmtEntryDeleteW		1
RpcNsMgmtEntryInqIfIds	RpcNsMgmtEntryInqIfIdsW		1
RpcNsProfileDelete	RpcNsProfileDeleteW		1
RpcNsProfileEltAdd	RpcNsProfileEltAddW		1
RpcNsProfileEltInqBegin	RpcNsProfileEltInqBeginW		1
RpcNsProfileEltInqNext	RpcNsProfileEltInqNextW		1
RpcNsProfileEltRemove	RpcNsProfileEltRemoveW		1
RpcProtseqVectorFree	RpcProtseqVectorFreeW		1
RpcServerInqCallAttributes	RpcServerInqCallAttributesW		1
RpcServerInqDefaultPrincName	RpcServerInqDefaultPrincNameW		1
RpcServerRegisterAuthInfo	RpcServerRegisterAuthInfoW		1
RpcServerUseProtseq	RpcServerUseProtseqW		1
RpcServerUseProtseqEp	RpcServerUseProtseqEpW		1
RpcServerUseProtseqEpEx	RpcServerUseProtseqEpExW		1
RpcServerUseProtseqEx	RpcServerUseProtseqExW		1
RpcServerUseProtseqIf	RpcServerUseProtseqIfW		1
RpcServerUseProtseqIfEx	RpcServerUseProtseqIfExW		1
RpcStringBindingCompose	RpcStringBindingComposeW		1
RpcStringBindingParse	RpcStringBindingParseW		1
RpcStringFree	RpcStringFreeW		1
RtlDecryptMemory	SystemFunction041		1
RtlEncryptMemory	SystemFunction040		1
RtlGenRandom	SystemFunction036		1
SCardAddReaderToGroup	SCardAddReaderToGroupW		1
SCardConnect	SCardConnectW		1
SCardForgetCardType	SCardForgetCardTypeW		1
SCardForgetReader	SCardForgetReaderW		1
SCardForgetReaderGroup	SCardForgetReaderGroupW		1
SCardGetCardTypeProviderName	SCardGetCardTypeProviderNameW		1
SCardGetProviderId	SCardGetProviderIdW		1
SCardGetReaderCapabilities	SCardGetAttrib		1
SCardGetStatusChange	SCardGetStatusChangeW		1
SCardIntroduceCardType	SCardIntroduceCardTypeW		1
SCardIntroduceReader	SCardIntroduceReaderW		1
SCardIntroduceReaderGroup	SCardIntroduceReaderGroupW		1
SCardListCardTypes	SCardListCardsW		1
SCardListCards	SCardListCardsW		1
SCardListInterfaces	SCardListInterfacesW		1
SCardListReaderGroups	SCardListReaderGroupsW		1
SCardListReaders	SCardListReadersW		1
SCardLocateCards	SCardLocateCardsW		1
SCardLocateCardsByATR	SCardLocateCardsByATRW		1
SCardRemoveReaderFromGroup	SCardRemoveReaderFromGroupW		1
SCardSetCardTypeProviderName	SCardSetCardTypeProviderNameW		1
SCardSetReaderCapabilities	SCardSetAttrib		1
SCardStatus	SCardStatusW		1
SCardUIDlgSelectCard	SCardUIDlgSelectCardW		1
SHBrowseForFolder	SHBrowseForFolderW		1
SHCopyKey	SHCopyKeyW		1
SHCreateDirectoryEx	SHCreateDirectoryExW		1
SHCreateFileExtractIcon	SHCreateFileExtractIconW		1
SHCreateStreamOnFile	SHCreateStreamOnFileW		1
SHDefExtractIcon	SHDefExtractIconW		1
SHDeleteEmptyKey	SHDeleteEmptyKeyW		1
SHDeleteKey	SHDeleteKeyW		1
SHDeleteValue	SHDeleteValueW		1
SHEmptyRecycleBin	SHEmptyRecycleBinW		1
SHEnumKeyEx	SHEnumKeyExW		1
SHEnumValue	SHEnumValueW		1
SHFileOperation	SHFileOperationW		1
SHFormatDateTime	SHFormatDateTimeW		1
SHGetDataFromIDList	SHGetDataFromIDListW		1
SHGetDiskFreeSpace	SHGetDiskFreeSpaceExW		1
SHGetDiskFreeSpaceEx	SHGetDiskFreeSpaceExW		1
SHGetFileInfo	SHGetFileInfoW		1
SHGetFolderPath	SHGetFolderPathW		1
SHGetFolderPathAndSubDir	SHGetFolderPathAndSubDirW		1
SHGetIconOverlayIndex	SHGetIconOverlayIndexW		1
SHGetNewLinkInfo	SHGetNewLinkInfoW		1
SHGetPathFromIDList	SHGetPathFromIDListW		1
SHGetSpecialFolderPath	SHGetSpecialFolderPathW		1
SHGetValue	SHGetValueW		1
SHInvokePrinterCommand	SHInvokePrinterCommandW		1
SHMessageBoxCheck	SHMessageBoxCheckW		1
SHOpenPropSheet	SHOpenPropSheetW		1
SHOpenRegStream	SHOpenRegStream2W		1
SHOpenRegStream2	SHOpenRegStream2W		1
SHPathPrepareForWrite	SHPathPrepareForWriteW		1
SHQueryInfoKey	SHQueryInfoKeyW		1
SHQueryRecycleBin	SHQueryRecycleBinW		1
SHQueryValueEx	SHQueryValueExW		1
SHRegCreateUSKey	SHRegCreateUSKeyW		1
SHRegDeleteEmptyUSKey	SHRegDeleteEmptyUSKeyW		1
SHRegDeleteUSValue	SHRegDeleteUSValueW		1
SHRegEnumUSKey	SHRegEnumUSKeyW		1
SHRegEnumUSValue	SHRegEnumUSValueW		1
SHRegGetBoolUSValue	SHRegGetBoolUSValueW		1
SHRegGetInt	SHRegGetIntW		1
SHRegGetPath	SHRegGetPathW		1
SHRegGetUSValue	SHRegGetUSValueW		1
SHRegOpenUSKey	SHRegOpenUSKeyW		1
SHRegQueryInfoUSKey	SHRegQueryInfoUSKeyW		1
SHRegQueryUSValue	SHRegQueryUSValueW		1
SHRegSetPath	SHRegSetPathW		1
SHRegSetUSValue	SHRegSetUSValueW		1
SHRegWriteUSValue	SHRegWriteUSValueW		1
SHSendMessageBroadcast	SHSendMessageBroadcastW		1
SHSetFolderPath	SHSetFolderPathW		1
SHSetValue	SHSetValueW		1
SHStartNetConnectionDialog	SHStartNetConnectionDialogW		1
SHStrDup	SHStrDupW		1
SHStripMneumonic	SHStripMneumonicW		1
SHUpdateImage	SHUpdateImageW		1
SID_CDWizardHost	IID_ICDBurnExt		1
SID_EnumerableView	IID_IEnumerableView		1
SID_IBindHost	IID_IBindHost		1
SID_LinkSite	IID_IShellLinkW		1
SID_PublishingWizard	CLSID_PublishingWizard		1
SID_SBandSite	IID_IBandSite		1
SID_SBindHost	IID_IBindHost		1
SID_SExplorerBrowserFrame	IID_ICommDlgBrowser		1
SID_SFolderView	IID_IFolderView		1
SID_SHlinkFrame	IID_IHlinkFrame		1
SID_SInternetExplorer	IID_IWebBrowserApp		1
SID_SInternetHostSecurityManager	IID_IInternetHostSecurityManager		1
SID_SInternetSecurityManager	IID_IInternetSecurityManager		1
SID_SNavigationPane	IID_INameSpaceTreeControl		1
SID_SNewMenuClient	IID_INewMenuClient		1
SID_SOleUndoManager	IID_IOleUndoManager		1
SID_SProfferService	IID_IProfferService		1
SID_SProgressUI	CLSID_ProgressDialog		1
SID_SProtectFocus	IID_IProtectFocus		1
SID_SShellBrowser	IID_IShellBrowser		1
SID_SShellDesktop	CLSID_ShellDesktop		1
SID_SUrlHistory	CLSID_CUrlHistory		1
SID_SWebBrowserApp	IID_IWebBrowserApp		1
SID_ShellFolderViewCB	IID_IShellFolderViewCB		1
SID_ShellTaskScheduler	IID_IShellTaskScheduler		1
SID_SkipHung	IID_IEnumVARIANT		1
SID_WebWizardHost	IID_IWebWizardExtension		1
SID_WizardSite	IID_IWizardSite		1
SNDMSG	SendMessageW		1
SaslEnumerateProfiles	SaslEnumerateProfilesW		1
SaslGetProfilePackage	SaslGetProfilePackageW		1
SaslIdentifyPackage	SaslIdentifyPackageW		1
SaslInitializeSecurityContext	SaslInitializeSecurityContextW		1
ScrollConsoleScreenBuffer	ScrollConsoleScreenBufferW		1
SearchPath	SearchPathW		1
SendDlgItemMessage	SendDlgItemMessageW		1
SendMessage	SendMessageW		1
SendMessageCallback	SendMessageCallbackW		1
SendMessageTimeout	SendMessageTimeoutW		1
SendNotifyMessage	SendNotifyMessageW		1
SetCalendarInfo	SetCalendarInfoW		1
SetClassLong	SetClassLongW		1
SetClassLongPtr	SetClassLongW		1
SetClassLongPtrA	SetClassLongA		1
SetClassLongPtrW	SetClassLongW		1
SetComputerName	SetComputerNameW		1
SetComputerNameEx	SetComputerNameExW		1
SetConsoleTitle	SetConsoleTitleW		1
SetContextAttributes	SetContextAttributesW		1
SetCurrentDirectory	SetCurrentDirectoryW		1
SetDefaultCommConfig	SetDefaultCommConfigW		1
SetDefaultPrinter	SetDefaultPrinterW		1
SetDlgItemText	SetDlgItemTextW		1
SetEnvironmentStrings	SetEnvironmentStringsW		1
SetEnvironmentVariable	SetEnvironmentVariableW		1
SetFileAttributes	SetFileAttributesW		1
SetFileSecurity	SetFileSecurityW		1
SetFileShortName	SetFileShortNameW		1
SetFirmwareEnvironmentVariable	SetFirmwareEnvironmentVariableW		1
SetForm	SetFormW		1
SetICMProfile	SetICMProfileW		1
SetJob	SetJobW		1
SetLocaleInfo	SetLocaleInfoW		1
SetMenuItemInfo	SetMenuItemInfoW		1
SetPort	SetPortW		1
SetPrinter	SetPrinterW		1
SetPrinterData	SetPrinterDataW		1
SetPrinterDataEx	SetPrinterDataExW		1
SetProp	SetPropW		1
SetService	SetServiceW		1
SetUrlCacheEntryGroup	SetUrlCacheEntryGroupW		1
SetUrlCacheEntryInfo	SetUrlCacheEntryInfoW		1
SetUrlCacheGroupAttribute	SetUrlCacheGroupAttributeW		1
SetUserObjectInformation	SetUserObjectInformationW		1
SetVolumeLabel	SetVolumeLabelW		1
SetVolumeMountPoint	SetVolumeMountPointW		1
SetWindowLong	SetWindowLongW		1
SetWindowLongPtr	SetWindowLongW		1
SetWindowLongPtrA	SetWindowLongA		1
SetWindowLongPtrW	SetWindowLongW		1
SetWindowText	SetWindowTextW		1
SetWindowsHook	SetWindowsHookW		1
SetWindowsHookEx	SetWindowsHookExW		1
SetupAddInstallSectionToDiskSpaceList	SetupAddInstallSectionToDiskSpaceListW		1
SetupAddSectionToDiskSpaceList	SetupAddSectionToDiskSpaceListW		1
SetupAddToDiskSpaceList	SetupAddToDiskSpaceListW		1
SetupAddToSourceList	SetupAddToSourceListW		1
SetupAdjustDiskSpaceList	SetupAdjustDiskSpaceListW		1
SetupBackupError	SetupBackupErrorW		1
SetupCommitFileQueue	SetupCommitFileQueueW		1
SetupCopyError	SetupCopyErrorW		1
SetupCopyOEMInf	SetupCopyOEMInfW		1
SetupCreateDiskSpaceList	SetupCreateDiskSpaceListW		1
SetupDecompressOrCopyFile	SetupDecompressOrCopyFileW		1
SetupDefaultQueueCallback	SetupDefaultQueueCallbackW		1
SetupDeleteError	SetupDeleteErrorW		1
SetupDiBuildClassInfoListEx	SetupDiBuildClassInfoListExW		1
SetupDiClassGuidsFromName	SetupDiClassGuidsFromNameW		1
SetupDiClassGuidsFromNameEx	SetupDiClassGuidsFromNameExW		1
SetupDiClassNameFromGuid	SetupDiClassNameFromGuidW		1
SetupDiClassNameFromGuidEx	SetupDiClassNameFromGuidExW		1
SetupDiCreateDevRegKey	SetupDiCreateDevRegKeyW		1
SetupDiCreateDeviceInfo	SetupDiCreateDeviceInfoW		1
SetupDiCreateDeviceInfoListEx	SetupDiCreateDeviceInfoListExW		1
SetupDiCreateDeviceInterface	SetupDiCreateDeviceInterfaceW		1
SetupDiCreateDeviceInterfaceRegKey	SetupDiCreateDeviceInterfaceRegKeyW		1
SetupDiCreateInterfaceDevice	SetupDiCreateDeviceInterfaceW		1
SetupDiCreateInterfaceDeviceA	SetupDiCreateDeviceInterfaceA		1
SetupDiCreateInterfaceDeviceRegKey	SetupDiCreateDeviceInterfaceRegKeyW		1
SetupDiCreateInterfaceDeviceRegKeyA	SetupDiCreateDeviceInterfaceRegKeyA		1
SetupDiCreateInterfaceDeviceRegKeyW	SetupDiCreateDeviceInterfaceRegKeyW		1
SetupDiCreateInterfaceDeviceW	SetupDiCreateDeviceInterfaceW		1
SetupDiDeleteInterfaceDeviceData	SetupDiDeleteDeviceInterfaceData		1
SetupDiDeleteInterfaceDeviceRegKey	SetupDiDeleteDeviceInterfaceRegKey		1
SetupDiEnumDriverInfo	SetupDiEnumDriverInfoW		1
SetupDiEnumInterfaceDevice	SetupDiEnumDeviceInterfaces		1
SetupDiGetActualSectionToInstall	SetupDiGetActualSectionToInstallW		1
SetupDiGetActualSectionToInstallEx	SetupDiGetActualSectionToInstallExW		1
SetupDiGetClassDescription	SetupDiGetClassDescriptionW		1
SetupDiGetClassDescriptionEx	SetupDiGetClassDescriptionExW		1
SetupDiGetClassDevPropertySheets	SetupDiGetClassDevPropertySheetsW		1
SetupDiGetClassDevs	SetupDiGetClassDevsW		1
SetupDiGetClassDevsEx	SetupDiGetClassDevsExW		1
SetupDiGetClassImageListEx	SetupDiGetClassImageListExW		1
SetupDiGetClassInstallParams	SetupDiGetClassInstallParamsW		1
SetupDiGetClassRegistryProperty	SetupDiGetClassRegistryPropertyW		1
SetupDiGetCustomDeviceProperty	SetupDiGetCustomDevicePropertyW		1
SetupDiGetDeviceInfoListDetail	SetupDiGetDeviceInfoListDetailW		1
SetupDiGetDeviceInstallParams	SetupDiGetDeviceInstallParamsW		1
SetupDiGetDeviceInstanceId	SetupDiGetDeviceInstanceIdW		1
SetupDiGetDeviceInterfaceDetail	SetupDiGetDeviceInterfaceDetailW		1
SetupDiGetDeviceRegistryProperty	SetupDiGetDeviceRegistryPropertyW		1
SetupDiGetDriverInfoDetail	SetupDiGetDriverInfoDetailW		1
SetupDiGetDriverInstallParams	SetupDiGetDriverInstallParamsW		1
SetupDiGetHwProfileFriendlyName	SetupDiGetHwProfileFriendlyNameW		1
SetupDiGetHwProfileFriendlyNameEx	SetupDiGetHwProfileFriendlyNameExW		1
SetupDiGetHwProfileListEx	SetupDiGetHwProfileListExW		1
SetupDiGetINFClass	SetupDiGetINFClassW		1
SetupDiGetInterfaceDeviceAlias	SetupDiGetDeviceInterfaceAlias		1
SetupDiGetInterfaceDeviceDetail	SetupDiGetDeviceInterfaceDetailW		1
SetupDiGetInterfaceDeviceDetailA	SetupDiGetDeviceInterfaceDetailA		1
SetupDiGetInterfaceDeviceDetailW	SetupDiGetDeviceInterfaceDetailW		1
SetupDiGetSelectedDriver	SetupDiGetSelectedDriverW		1
SetupDiInstallClass	SetupDiInstallClassW		1
SetupDiInstallClassEx	SetupDiInstallClassExW		1
SetupDiInstallInterfaceDevices	SetupDiInstallDeviceInterfaces		1
SetupDiOpenClassRegKeyEx	SetupDiOpenClassRegKeyExW		1
SetupDiOpenDeviceInfo	SetupDiOpenDeviceInfoW		1
SetupDiOpenDeviceInterface	SetupDiOpenDeviceInterfaceW		1
SetupDiOpenInterfaceDevice	SetupDiOpenDeviceInterfaceW		1
SetupDiOpenInterfaceDeviceA	SetupDiOpenDeviceInterfaceA		1
SetupDiOpenInterfaceDeviceRegKey	SetupDiOpenDeviceInterfaceRegKey		1
SetupDiOpenInterfaceDeviceW	SetupDiOpenDeviceInterfaceW		1
SetupDiRemoveInterfaceDevice	SetupDiRemoveDeviceInterface		1
SetupDiSetClassInstallParams	SetupDiSetClassInstallParamsW		1
SetupDiSetClassRegistryProperty	SetupDiSetClassRegistryPropertyW		1
SetupDiSetDeviceInstallParams	SetupDiSetDeviceInstallParamsW		1
SetupDiSetDeviceRegistryProperty	SetupDiSetDeviceRegistryPropertyW		1
SetupDiSetDriverInstallParams	SetupDiSetDriverInstallParamsW		1
SetupDiSetSelectedDriver	SetupDiSetSelectedDriverW		1
SetupDuplicateDiskSpaceList	SetupDuplicateDiskSpaceListW		1
SetupEnumInfSections	SetupEnumInfSectionsW		1
SetupFindFirstLine	SetupFindFirstLineW		1
SetupFindNextMatchLine	SetupFindNextMatchLineW		1
SetupFreeSourceList	SetupFreeSourceListW		1
SetupGetBackupInformation	SetupGetBackupInformationW		1
SetupGetFileCompressionInfo	SetupGetFileCompressionInfoW		1
SetupGetFileCompressionInfoEx	SetupGetFileCompressionInfoExW		1
SetupGetInfFileList	SetupGetInfFileListW		1
SetupGetInfInformation	SetupGetInfInformationW		1
SetupGetLineByIndex	SetupGetLineByIndexW		1
SetupGetLineCount	SetupGetLineCountW		1
SetupGetLineText	SetupGetLineTextW		1
SetupGetMultiSzField	SetupGetMultiSzFieldW		1
SetupGetSourceFileLocation	SetupGetSourceFileLocationW		1
SetupGetSourceFileSize	SetupGetSourceFileSizeW		1
SetupGetSourceInfo	SetupGetSourceInfoW		1
SetupGetStringField	SetupGetStringFieldW		1
SetupGetTargetPath	SetupGetTargetPathW		1
SetupInitializeFileLog	SetupInitializeFileLogW		1
SetupInstallFile	SetupInstallFileW		1
SetupInstallFileEx	SetupInstallFileExW		1
SetupInstallFilesFromInfSection	SetupInstallFilesFromInfSectionW		1
SetupInstallFromInfSection	SetupInstallFromInfSectionW		1
SetupInstallServicesFromInfSection	SetupInstallServicesFromInfSectionW		1
SetupInstallServicesFromInfSectionEx	SetupInstallServicesFromInfSectionExW		1
SetupIterateCabinet	SetupIterateCabinetW		1
SetupLogError	SetupLogErrorW		1
SetupLogFile	SetupLogFileW		1
SetupOpenAppendInfFile	SetupOpenAppendInfFileW		1
SetupOpenInfFile	SetupOpenInfFileW		1
SetupPrepareQueueForRestore	SetupPrepareQueueForRestoreW		1
SetupPromptForDisk	SetupPromptForDiskW		1
SetupQueryDrivesInDiskSpaceList	SetupQueryDrivesInDiskSpaceListW		1
SetupQueryFileLog	SetupQueryFileLogW		1
SetupQueryInfFileInformation	SetupQueryInfFileInformationW		1
SetupQueryInfOriginalFileInformation	SetupQueryInfOriginalFileInformationW		1
SetupQueryInfVersionInformation	SetupQueryInfVersionInformationW		1
SetupQuerySourceList	SetupQuerySourceListW		1
SetupQuerySpaceRequiredOnDrive	SetupQuerySpaceRequiredOnDriveW		1
SetupQueueCopy	SetupQueueCopyW		1
SetupQueueCopyIndirect	SetupQueueCopyIndirectW		1
SetupQueueCopySection	SetupQueueCopySectionW		1
SetupQueueDefaultCopy	SetupQueueDefaultCopyW		1
SetupQueueDelete	SetupQueueDeleteW		1
SetupQueueDeleteSection	SetupQueueDeleteSectionW		1
SetupQueueRename	SetupQueueRenameW		1
SetupQueueRenameSection	SetupQueueRenameSectionW		1
SetupRemoveFileLogEntry	SetupRemoveFileLogEntryW		1
SetupRemoveFromDiskSpaceList	SetupRemoveFromDiskSpaceListW		1
SetupRemoveFromSourceList	SetupRemoveFromSourceListW		1
SetupRemoveInstallSectionFromDiskSpaceList	SetupRemoveInstallSectionFromDiskSpaceListW		1
SetupRemoveSectionFromDiskSpaceList	SetupRemoveSectionFromDiskSpaceListW		1
SetupRenameError	SetupRenameErrorW		1
SetupScanFileQueue	SetupScanFileQueueW		1
SetupSetDirectoryId	SetupSetDirectoryIdW		1
SetupSetDirectoryIdEx	SetupSetDirectoryIdExW		1
SetupSetFileQueueAlternatePlatform	SetupSetFileQueueAlternatePlatformW		1
SetupSetPlatformPathOverride	SetupSetPlatformPathOverrideW		1
SetupSetSourceList	SetupSetSourceListW		1
SetupUninstallOEMInf	SetupUninstallOEMInfW		1
SetupVerifyInfFile	SetupVerifyInfFileW		1
ShellAbout	ShellAboutW		1
ShellExecute	ShellExecuteW		1
ShellExecuteEx	ShellExecuteExW		1
ShellMessageBox	ShellMessageBoxW		1
Shell_NotifyIcon	Shell_NotifyIconW		1
SspiPromptForCredentials	SspiPromptForCredentialsW		1
StartDoc	StartDocW		1
StartDocPrinter	StartDocPrinterW		1
StartService	StartServiceW		1
StartServiceCtrlDispatcher	StartServiceCtrlDispatcherW		1
StoragePortClassGuid	GUID_DEVINTERFACE_STORAGEPORT		1
StrCSpn	StrCSpnW		1
StrCSpnI	StrCSpnIW		1
StrCat	StrCatW		1
StrCatA	lstrcatA		1
StrCatBuff	StrCatBuffW		1
StrCatN	StrNCatW		1
StrChr	StrChrW		1
StrChrI	StrChrIW		1
StrCmp	StrCmpW		1
StrCmpA	lstrcmpA		1
StrCmpI	StrCmpIW		1
StrCmpIA	lstrcmpiA		1
StrCmpN	StrCmpNW		1
StrCmpNC	StrCmpNCW		1
StrCmpNI	StrCmpNIW		1
StrCmpNIC	StrCmpNICW		1
StrCpy	StrCpyW		1
StrCpyA	lstrcpyA		1
StrCpyN	StrCpyNW		1
StrCpyNA	lstrcpynA		1
StrDup	StrDupW		1
StrFormatByteSize	StrFormatByteSizeW		1
StrFormatByteSize64	StrFormatByteSizeW		1
StrFormatKBSize	StrFormatKBSizeW		1
StrFromTimeInterval	StrFromTimeIntervalW		1
StrIsIntlEqual	StrIsIntlEqualW		1
StrNCat	StrNCatW		1
StrNCmp	StrCmpNW		1
StrNCmpI	StrCmpNIW		1
StrNCpy	StrCpyNW		1
StrPBrk	StrPBrkW		1
StrRChr	StrRChrW		1
StrRChrI	StrRChrIW		1
StrRStrI	StrRStrIW		1
StrRetToBuf	StrRetToBufW		1
StrRetToStr	StrRetToStrW		1
StrSpn	StrSpnW		1
StrStr	StrStrW		1
StrStrI	StrStrIW		1
StrToInt	StrToIntW		1
StrToIntEx	StrToIntExW		1
StrToLong	StrToIntW		1
StrTrim	StrTrimW		1
SystemParametersInfo	SystemParametersInfoW		1
TOID_NULL	GUID_NULL		1
TabbedTextOut	TabbedTextOutW		1
TapeClassGuid	GUID_DEVINTERFACE_TAPE		1
TextOut	TextOutW		1
TranslateAccelerator	TranslateAcceleratorW		1
URLDownloadToCacheFile	URLDownloadToCacheFileW		1
URLDownloadToFile	URLDownloadToFileW		1
URLOpenBlockingStream	URLOpenBlockingStreamW		1
URLOpenPullStream	URLOpenPullStreamW		1
URLOpenStream	URLOpenStreamW		1
UnlockUrlCacheEntryFile	UnlockUrlCacheEntryFileW		1
UnregisterClass	UnregisterClassW		1
UpdateICMRegKey	UpdateICMRegKeyW		1
UpdateResource	UpdateResourceW		1
UrlApplyScheme	UrlApplySchemeW		1
UrlCanonicalize	UrlCanonicalizeW		1
UrlCombine	UrlCombineW		1
UrlCompare	UrlCompareW		1
UrlCreateFromPath	UrlCreateFromPathW		1
UrlEscape	UrlEscapeW		1
UrlFixup	UrlFixupW		1
UrlGetLocation	UrlGetLocationW		1
UrlGetPart	UrlGetPartW		1
UrlHash	UrlHashW		1
UrlIs	UrlIsW		1
UrlIsOpaque	UrlIsOpaqueW		1
UrlUnescape	UrlUnescapeW		1
UuidFromString	UuidFromStringW		1
UuidToString	UuidToStringW		1
VarBoolFromInt	VarBoolFromI4		1
VarBoolFromUint	VarBoolFromUI4		1
VarBstrFromInt	VarBstrFromI4		1
VarBstrFromUint	VarBstrFromUI4		1
VarCyFromInt	VarCyFromI4		1
VarCyFromUint	VarCyFromUI4		1
VarDateFromInt	VarDateFromI4		1
VarDateFromUint	VarDateFromUI4		1
VarDecFromInt	VarDecFromI4		1
VarDecFromUint	VarDecFromUI4		1
VarI1FromInt	VarI1FromI4		1
VarI1FromUint	VarI1FromUI4		1
VarI2FromInt	VarI2FromI4		1
VarI2FromUint	VarI2FromUI4		1
VarI4FromUint	VarI4FromUI4		1
VarI8FromInt	VarI8FromI4		1
VarI8FromUint	VarI8FromUI4		1
VarIntFromBool	VarI4FromBool		1
VarIntFromCy	VarI4FromCy		1
VarIntFromDate	VarI4FromDate		1
VarIntFromDec	VarI4FromDec		1
VarIntFromDisp	VarI4FromDisp		1
VarIntFromI1	VarI4FromI1		1
VarIntFromI2	VarI4FromI2		1
VarIntFromI8	VarI4FromI8		1
VarIntFromR4	VarI4FromR4		1
VarIntFromR8	VarI4FromR8		1
VarIntFromStr	VarI4FromStr		1
VarIntFromUI1	VarI4FromUI1		1
VarIntFromUI2	VarI4FromUI2		1
VarIntFromUI4	VarI4FromUI4		1
VarIntFromUI8	VarI4FromUI8		1
VarIntFromUint	VarI4FromUI4		1
VarR4FromInt	VarR4FromI4		1
VarR4FromUint	VarR4FromUI4		1
VarR8FromInt	VarR8FromI4		1
VarR8FromUint	VarR8FromUI4		1
VarUI1FromInt	VarUI1FromI4		1
VarUI1FromUint	VarUI1FromUI4		1
VarUI2FromInt	VarUI2FromI4		1
VarUI2FromUint	VarUI2FromUI4		1
VarUI4FromInt	VarUI4FromI4		1
VarUintFromBool	VarUI4FromBool		1
VarUintFromCy	VarUI4FromCy		1
VarUintFromDate	VarUI4FromDate		1
VarUintFromDec	VarUI4FromDec		1
VarUintFromDisp	VarUI4FromDisp		1
VarUintFromI1	VarUI4FromI1		1
VarUintFromI2	VarUI4FromI2		1
VarUintFromI4	VarUI4FromI4		1
VarUintFromI8	VarUI4FromI8		1
VarUintFromInt	VarUI4FromI4		1
VarUintFromR4	VarUI4FromR4		1
VarUintFromR8	VarUI4FromR8		1
VarUintFromStr	VarUI4FromStr		1
VarUintFromUI1	VarUI4FromUI1		1
VarUintFromUI2	VarUI4FromUI2		1
VarUintFromUI8	VarUI4FromUI8		1
VerFindFile	VerFindFileW		1
VerInstallFile	VerInstallFileW		1
VerLanguageName	VerLanguageNameW		1
VerQueryValue	VerQueryValueW		1
VerifyVersionInfo	VerifyVersionInfoW		1
VkKeyScan	VkKeyScanW		1
VkKeyScanEx	VkKeyScanExW		1
VolumeClassGuid	GUID_DEVINTERFACE_VOLUME		1
WNetAddConnection	WNetAddConnectionW		1
WNetAddConnection2	WNetAddConnection2W		1
WNetAddConnection3	WNetAddConnection3W		1
WNetCancelConnection	WNetCancelConnectionW		1
WNetCancelConnection2	WNetCancelConnection2W		1
WNetConnectionDialog1	WNetConnectionDialog1W		1
WNetDisconnectDialog1	WNetDisconnectDialog1W		1
WNetEnumResource	WNetEnumResourceW		1
WNetGetConnection	WNetGetConnectionW		1
WNetGetLastError	WNetGetLastErrorW		1
WNetGetNetworkInformation	WNetGetNetworkInformationW		1
WNetGetProviderName	WNetGetProviderNameW		1
WNetGetResourceInformation	WNetGetResourceInformationW		1
WNetGetResourceParent	WNetGetResourceParentW		1
WNetGetUniversalName	WNetGetUniversalNameW		1
WNetGetUser	WNetGetUserW		1
WNetOpenEnum	WNetOpenEnumW		1
WNetUseConnection	WNetUseConnectionW		1
WSAAddressToString	WSAAddressToStringW		1
WSAConnectByName	WSAConnectByNameW		1
WSADuplicateSocket	WSADuplicateSocketW		1
WSAEnumNameSpaceProviders	WSAEnumNameSpaceProvidersW		1
WSAEnumProtocols	WSAEnumProtocolsW		1
WSAGetServiceClassInfo	WSAGetServiceClassInfoW		1
WSAGetServiceClassNameByClassId	WSAGetServiceClassNameByClassIdW		1
WSAInstallServiceClass	WSAInstallServiceClassW		1
WSALookupServiceBegin	WSALookupServiceBeginW		1
WSALookupServiceNext	WSALookupServiceNextW		1
WSASetService	WSASetServiceW		1
WSASocket	WSASocketW		1
WSAStringToAddress	WSAStringToAddressW		1
WaitNamedPipe	WaitNamedPipeW		1
WinHelp	WinHelpW		1
WriteConsole	WriteConsoleW		1
WriteConsoleInput	WriteConsoleInputW		1
WriteConsoleOutput	WriteConsoleOutputW		1
WriteConsoleOutputCharacter	WriteConsoleOutputCharacterW		1
WriteOnceDiskClassGuid	GUID_DEVINTERFACE_WRITEONCEDISK		1
WritePrivateProfileSection	WritePrivateProfileSectionW		1
WritePrivateProfileString	WritePrivateProfileStringW		1
WritePrivateProfileStruct	WritePrivateProfileStructW		1
WriteProfileSection	WriteProfileSectionW		1
WriteProfileString	WriteProfileStringW		1
XcvData	XcvDataW		1
YieldProcessor	_mm_pause		1
__UA_WCSLEN	wcslen		1
__stat64	_stat64		1
_clear87	_clearfp		1
_fstat	_fstat64i32		1
_fstati64	_fstat64		1
_ftime	_ftime64		1
_ftime_s	_ftime64_s		1
_matherrl	_matherr		1
_stat	_stat64i32		1
_stati64	_stat64		1
_status87	_statusfp		1
_wfindfirst	_wfindfirst64i32		1
_wfindfirsti64	_wfindfirst64		1
_wfindnext	_wfindnext64i32		1
_wfindnexti64	_wfindnext64		1
_wgetdcwd_nolock	_wgetdcwd		1
_wstat	_wstat64i32		1
_wstati64	_wstat64		1
abnormal_termination	_abnormal_termination		1
acmDriverAdd	acmDriverAddW		1
acmDriverDetails	acmDriverDetailsW		1
acmFilterChoose	acmFilterChooseW		1
acmFilterDetails	acmFilterDetailsW		1
acmFilterEnum	acmFilterEnumW		1
acmFilterTagDetails	acmFilterTagDetailsW		1
acmFilterTagEnum	acmFilterTagEnumW		1
acmFormatChoose	acmFormatChooseW		1
acmFormatDetails	acmFormatDetailsW		1
acmFormatEnum	acmFormatEnumW		1
acmFormatTagDetails	acmFormatTagDetailsW		1
acmFormatTagEnum	acmFormatTagEnumW		1
auxGetDevCaps	auxGetDevCapsW		1
capCreateCaptureWindow	capCreateCaptureWindowW		1
capGetDriverDescription	capGetDriverDescriptionW		1
exception_code	_exception_code		1
joyGetDevCaps	joyGetDevCapsW		1
lstrcat	lstrcatW		1
lstrcmp	lstrcmpW		1
lstrcmpi	lstrcmpiW		1
lstrcpy	lstrcpyW		1
lstrcpyn	lstrcpynW		1
lstrlen	lstrlenW		1
mciGetDeviceID	mciGetDeviceIDW		1
mciGetDeviceIDFromElementID	mciGetDeviceIDFromElementIDW		1
mciGetErrorString	mciGetErrorStringW		1
mciSendCommand	mciSendCommandW		1
mciSendString	mciSendStringW		1
midiInGetDevCaps	midiInGetDevCapsW		1
midiInGetErrorText	midiInGetErrorTextW		1
midiOutGetDevCaps	midiOutGetDevCapsW		1
midiOutGetErrorText	midiOutGetErrorTextW		1
midl_user_allocate	MIDL_user_allocate		1
midl_user_free	MIDL_user_free		1
mixerGetControlDetails	mixerGetControlDetailsW		1
mixerGetDevCaps	mixerGetDevCapsW		1
mixerGetLineControls	mixerGetLineControlsW		1
mixerGetLineInfo	mixerGetLineInfoW		1
mmioInstallIOProc	mmioInstallIOProcW		1
mmioOpen	mmioOpenW		1
mmioRename	mmioRenameW		1
mmioStringToFOURCC	mmioStringToFOURCCW		1
setjmp	_setjmp		1
sndPlaySound	sndPlaySoundW		1
ua_CharUpper	CharUpperW		1
ua_CharUpperW	CharUpperW		1
ua_lstrcmp	lstrcmpW		1
ua_lstrcmpW	lstrcmpW		1
ua_lstrcmpi	lstrcmpiW		1
ua_lstrcmpiW	lstrcmpiW		1
ua_lstrlen	lstrlenW		1
ua_lstrlenW	lstrlenW		1
ua_tcscpy_s	wcscpy_s		1
ua_wcschr	wcschr		1
ua_wcscpy_s	wcscpy_s		1
ua_wcsicmp	wcsicmp		1
ua_wcslen	wcslen		1
ua_wcsrchr	wcsrchr		1
waveInGetDevCaps	waveInGetDevCapsW		1
waveInGetErrorText	waveInGetErrorTextW		1
waveOutGetDevCaps	waveOutGetDevCapsW		1
waveOutGetErrorText	waveOutGetErrorTextW		1
wglUseFontBitmaps	wglUseFontBitmapsW		1
wglUseFontOutlines	wglUseFontOutlinesW		1
wnsprintf	wnsprintfW		1
wsprintf	wsprintfW		1
wvnsprintf	wvnsprintfW		1
wvsprintf	wvsprintfW		1
